AAACTTTATTCAGTTAACACGAAA -> AACTTTATTCAGTTAACACGAAAT
TAATGCACTCTGGAGCACAATACC -> AATGCACTCTGGAGCACAATACCG
AAATGGCACTGCCCTAGATTTCAA -> AATGGCACTGCCCTAGATTTCAAC
GTCATAGTTACGAACGCTCGCATG -> TCATAGTTACGAACGCTCGCATGG
GTTACATCGGTAGAAGACTGTTTT -> TTACATCGGTAGAAGACTGTTTTC
GGCAGACACGATCAAGTCACAAAG -> GCAGACACGATCAAGTCACAAAGG
GTCCTTCTGTGCCCCGGCCCTCGC -> TCCTTCTGTGCCCCGGCCCTCGCT
AGGTACGCCCCGATCGCATATCCT -> GGTACGCCCCGATCGCATATCCTA
GCCTGAGAAAGAAAGCTACGCTGA -> CCTGAGAAAGAAAGCTACGCTGAA
TTAACACGAAATGACCGGGATTAA -> TAACACGAAATGACCGGGATTAAC
ATATTTCGGATTTGTGCCAAATGC -> TATTTCGGATTTGTGCCAAATGCT
CCCTAGATTTCAACCATGACAGCA -> CCTAGATTTCAACCATGACAGCAC
CGGTGGGCTTCGGGTTCTCCGTCT -> GGTGGGCTTCGGGTTCTCCGTCTG
GATGTTACATCGGTAGAAGACTGT -> ATGTTACATCGGTAGAAGACTGTT
TAGTTCAGTAACAAGTCGTGCCGT -> AGTTCAGTAACAAGTCGTGCCGTG
TTCTGTGCCCCGGCCCTCGCTTAA -> TCTGTGCCCCGGCCCTCGCTTAAT
ACTGAAAGTGTCTGGTATCATAAA -> CTGAAAGTGTCTGGTATCATAAAA
ACCCTCACACCGGTGCACAGTGTT -> CCCTCACACCGGTGCACAGTGTTG
GTTGAGTTCTGGGATAAGTTCGCA -> TTGAGTTCTGGGATAAGTTCGCAT
GGGTTCTCCGTCTGACACTGGAAC -> GGTTCTCCGTCTGACACTGGAACG
CACGGCGATGAGGCGTCAGCCGAA -> ACGGCGATGAGGCGTCAGCCGAAA
AAAACACACGGCGATGAGGCGTCA -> AAACACACGGCGATGAGGCGTCAG
TACTTCAAAACGACTTAGAGGAAT -> ACTTCAAAACGACTTAGAGGAATG
ATCCTCGAGTCCGTGATGCCTGGT -> TCCTCGAGTCCGTGATGCCTGGTA
CCGGTGACTGTTATGCCTCTTGCG -> CGGTGACTGTTATGCCTCTTGCGT
CGCGACTCGTAAACGAAGGCTTCA -> GCGACTCGTAAACGAAGGCTTCAT
CGGGATGAGATATTTCGGATTTGT -> GGGATGAGATATTTCGGATTTGTG
AGCACGGACTTAGCCTGCGTATCA -> GCACGGACTTAGCCTGCGTATCAG
GCATATCCTAGCAGCGACCAGGCG -> CATATCCTAGCAGCGACCAGGCGT
GGCCGCTGATCGTGTTAGAGAAAA -> GCCGCTGATCGTGTTAGAGAAAAC
CCGTAGCCTGAGAAAGAAAGCTAC -> CGTAGCCTGAGAAAGAAAGCTACG
CCTTCACCATCCTCGAGTCCGTGA -> CTTCACCATCCTCGAGTCCGTGAT
GCACAGTGTTGAGTGGGGACGAAA -> CACAGTGTTGAGTGGGGACGAAAA
CAAAGGTATGACACCAAAAGAAGT -> AAAGGTATGACACCAAAAGAAGTT
TCGTTATGGATTCGTTATGTCGAA -> CGTTATGGATTCGTTATGTCGAAA
ACTTTCAGTAGACATCCCTACTAC -> CTTTCAGTAGACATCCCTACTACC
AGTCCATTTGCTTTGGAGGTTTTG -> GTCCATTTGCTTTGGAGGTTTTGC
CCCGTAGCCTGAGAAAGAAAGCTA -> CCGTAGCCTGAGAAAGAAAGCTAC
CTTCACCATCCTCGAGTCCGTGAT -> TTCACCATCCTCGAGTCCGTGATG
GTCGCGACTCGTAAACGAAGGCTT -> TCGCGACTCGTAAACGAAGGCTTC
TCGTCTTAATACTGAAAGTGTCTG -> CGTCTTAATACTGAAAGTGTCTGG
ATGGCGTGCAGGTGTATAGCTCTG -> TGGCGTGCAGGTGTATAGCTCTGT
TGTCGGCATGTCTAAGCTTGCTGG -> GTCGGCATGTCTAAGCTTGCTGGG
GTTTTGCCTGTAAAGCGAAGGGGT -> TTTTGCCTGTAAAGCGAAGGGGTG
TCGGATTTGTGCCAAATGCTGCAG -> CGGATTTGTGCCAAATGCTGCAGT
AAGTCGTGCCGTGGGCCGCTGATC -> AGTCGTGCCGTGGGCCGCTGATCG
CGTAGCCTGAGAAAGAAAGCTACG -> GTAGCCTGAGAAAGAAAGCTACGC
CAACTAGACAGCGCCTGACCATCA -> AACTAGACAGCGCCTGACCATCAC
CTAGTTCAGTAACAAGTCGTGCCG -> TAGTTCAGTAACAAGTCGTGCCGT
GAACGCTCGCATGGCGTGCAGGTG -> AACGCTCGCATGGCGTGCAGGTGT
AGTCCGTGATGCCTGGTAAGCAGT -> GTCCGTGATGCCTGGTAAGCAGTT
CCCGCGTTCCCGCGGGATGAGATA -> CCGCGTTCCCGCGGGATGAGATAT
CAGCGCCTGACCATCACCTTCACC -> AGCGCCTGACCATCACCTTCACCA
TCTGGAGCACAATACCGAGTGTTA -> CTGGAGCACAATACCGAGTGTTAA
ACTCCTCCAAAGCCTCCACGCAGT -> CTCCTCCAAAGCCTCCACGCAGTT
GTTAACCTCTCGTCTGATGCGCAC -> TTAACCTCTCGTCTGATGCGCACT
CGGACTTAGCCTGCGTATCAGTCC -> GGACTTAGCCTGCGTATCAGTCCC
CGTCGCGACTCGTAAACGAAGGCT -> GTCGCGACTCGTAAACGAAGGCTT
GACTAATCCTCGGATGGCTCTCAA -> ACTAATCCTCGGATGGCTCTCAAT
GTCTGACACTGGAACGTCCGGTGA -> TCTGACACTGGAACGTCCGGTGAC
TCCGTGATGCCTGGTAAGCAGTTT -> CCGTGATGCCTGGTAAGCAGTTTG
CGATGAGGCGTCAGCCGAAACTTT -> GATGAGGCGTCAGCCGAAACTTTA
AAGGATGATAGCAACACCTGTTAT -> AGGATGATAGCAACACCTGTTATA
GGGCTCGAAGTATCGCACTAGTGT -> GGCTCGAAGTATCGCACTAGTGTT
CACCATCCTCGAGTCCGTGATGCC -> ACCATCCTCGAGTCCGTGATGCCT
GAAACGATGGCTTGAACCTCTGCT -> AAACGATGGCTTGAACCTCTGCTT
CTGAGAAAGAAAGCTACGCTGAAT -> TGAGAAAGAAAGCTACGCTGAATA
GTTTGGCGGGAGGGGTGTAAGCAT -> TTTGGCGGGAGGGGTGTAAGCATG
CCGTGATGCCTGGTAAGCAGTTTG -> CGTGATGCCTGGTAAGCAGTTTGG
TTTGCTTTGGAGGTTTTGCCTGTA -> TTGCTTTGGAGGTTTTGCCTGTAA
GTCCCGCGTTCCCGCGGGATGAGA -> TCCCGCGTTCCCGCGGGATGAGAT
CTCGTAAACGAAGGCTTCATTAGT -> TCGTAAACGAAGGCTTCATTAGTC
CGTTAACCTCTCGTCTGATGCGCA -> GTTAACCTCTCGTCTGATGCGCAC
ATTTGCTTTGGAGGTTTTGCCTGT -> TTTGCTTTGGAGGTTTTGCCTGTA
TTAGTTGAGCATAGTGCGTCGAAG -> TAGTTGAGCATAGTGCGTCGAAGT
ACGTCCGGTGACTGTTATGCCTCT -> CGTCCGGTGACTGTTATGCCTCTT
CGACCAGGCGTCGCGACTCGTAAA -> GACCAGGCGTCGCGACTCGTAAAC
ACGAAAATGGCACTGCCCTAGATT -> CGAAAATGGCACTGCCCTAGATTT
TTGTCCCTTATGACTCAAACAGCG -> TGTCCCTTATGACTCAAACAGCGA
ACACTGGAACGTCCGGTGACTGTT -> CACTGGAACGTCCGGTGACTGTTA
TAGCAGCGACCAGGCGTCGCGACT -> AGCAGCGACCAGGCGTCGCGACTC
TACATCGGTAGAAGACTGTTTTCC -> ACATCGGTAGAAGACTGTTTTCCG
ACGACTTAGAGGAATGGGCCGTTA -> CGACTTAGAGGAATGGGCCGTTAA
GCGGGATGAGATATTTCGGATTTG -> CGGGATGAGATATTTCGGATTTGT
TCCAAAGCCTCCACGCAGTTCGGA -> CCAAAGCCTCCACGCAGTTCGGAG
TGTTGAGTGGGGACGAAAATGGCA -> GTTGAGTGGGGACGAAAATGGCAC
CTCCAGGAGTTCGTTATGGATTCG -> TCCAGGAGTTCGTTATGGATTCGT
CACTAGTGTTTGGCGGGAGGGGTG -> ACTAGTGTTTGGCGGGAGGGGTGT
TAATTTGCAGCTTATAATGCGATC -> AATTTGCAGCTTATAATGCGATCA
CTGCCCTAGATTTCAACCATGACA -> TGCCCTAGATTTCAACCATGACAG
CTCCAAAGCCTCCACGCAGTTCGG -> TCCAAAGCCTCCACGCAGTTCGGA
ATGCCTGGTAAGCAGTTTGGGGCA -> TGCCTGGTAAGCAGTTTGGGGCAG
CCGAAACTTTATTCAGTTAACACG -> CGAAACTTTATTCAGTTAACACGA
GCGCCAAATAGCGGGCACCACACG -> CGCCAAATAGCGGGCACCACACGT
CATCCGTGACCACAAAGATGTCAG -> ATCCGTGACCACAAAGATGTCAGT
ACCACACGTGGATGCCCGGTCGTC -> CCACACGTGGATGCCCGGTCGTCG
GGTCGTCGAGTGACGTACTCAACT -> GTCGTCGAGTGACGTACTCAACTA
ATCGCGCCAAATAGCGGGCACCAC -> TCGCGCCAAATAGCGGGCACCACA
CTAGAATCAAGAATCTGAGACGTT -> TAGAATCAAGAATCTGAGACGTTG
TGTCATGTCCCGCGTTCCCGCGGG -> GTCATGTCCCGCGTTCCCGCGGGA
ATAGCAACACCTGTTATAGGCTTC -> TAGCAACACCTGTTATAGGCTTCT
ATCCGTGACCACAAAGATGTCAGT -> TCCGTGACCACAAAGATGTCAGTT
AGTTTCCTATCTAATACGCTATAT -> GTTTCCTATCTAATACGCTATATA
GTCCGGTGACTGTTATGCCTCTTG -> TCCGGTGACTGTTATGCCTCTTGC
GTGGGAGCACGACTAATCCTCGGA -> TGGGAGCACGACTAATCCTCGGAT
TCACACCGGTGCACAGTGTTGAGT -> CACACCGGTGCACAGTGTTGAGTG
TGCGCTCGATTAGTTGAGCATAGT -> GCGCTCGATTAGTTGAGCATAGTG
ATCATAAAACAGTGCAGCAATATC -> TCATAAAACAGTGCAGCAATATCC
ACAGTGCAGCAATATCCCGTCATA -> CAGTGCAGCAATATCCCGTCATAG
AGACATCCCTACTACCAACGACAA -> GACATCCCTACTACCAACGACAAC
TCAGTAGACATCCCTACTACCAAC -> CAGTAGACATCCCTACTACCAACG
ATTGGGCGCCCCAAGCCAAGGATG -> TTGGGCGCCCCAAGCCAAGGATGA
TATGACACCAAAAGAAGTTGAGTT -> ATGACACCAAAAGAAGTTGAGTTC
GCACTTTCAGTAGACATCCCTACT -> CACTTTCAGTAGACATCCCTACTA
CTGTCTTCTGGCAAGTAATAGTAG -> TGTCTTCTGGCAAGTAATAGTAGT
TCACGGATACTTGTCGTAACTACG -> CACGGATACTTGTCGTAACTACGC
TCGGTAATTGGGCGCCCCAAGCCA -> CGGTAATTGGGCGCCCCAAGCCAA
ACGACAACTCGGGGAGCCACATGA -> CGACAACTCGGGGAGCCACATGAG
ATGCGCTCGATTAGTTGAGCATAG -> TGCGCTCGATTAGTTGAGCATAGT
GACAGCACGGACTTAGCCTGCGTA -> ACAGCACGGACTTAGCCTGCGTAT
AGAAGACTGTTTTCCGTCGCTGTC -> GAAGACTGTTTTCCGTCGCTGTCT
TGGTGGGAGCACGACTAATCCTCG -> GGTGGGAGCACGACTAATCCTCGG
AAGCAGACATAATGCACTCTGGAG -> AGCAGACATAATGCACTCTGGAGC
CTTTCAGTAGACATCCCTACTACC -> TTTCAGTAGACATCCCTACTACCA
CACCTTCACCATCCTCGAGTCCGT -> ACCTTCACCATCCTCGAGTCCGTG
TAGAGAAAACACACGGCGATGAGG -> AGAGAAAACACACGGCGATGAGGC
TAGCGGGCACCACACGTGGATGCC -> AGCGGGCACCACACGTGGATGCCC
GCCTGCCTCTCCAGGAGTTCGTTA -> CCTGCCTCTCCAGGAGTTCGTTAT
CTGGGATAAGTTCGCATCGGGCGC -> TGGGATAAGTTCGCATCGGGCGCC
CTTATGACTCAAACAGCGAAGGAT -> TTATGACTCAAACAGCGAAGGATA
AGAATCAAGAATCTGAGACGTTGT -> GAATCAAGAATCTGAGACGTTGTG
GGCTTGAACCTCTGCTTAGATGTT -> GCTTGAACCTCTGCTTAGATGTTA
GATGGCTTGAACCTCTGCTTAGAT -> ATGGCTTGAACCTCTGCTTAGATG
GCGATGAGGCGTCAGCCGAAACTT -> CGATGAGGCGTCAGCCGAAACTTT
TCCTATCTAATACGCTATATAATT -> CCTATCTAATACGCTATATAATTT
ATCACGGATACTTGTCGTAACTAC -> TCACGGATACTTGTCGTAACTACG
CATGAATTGACGGCAGGCGTTGTC -> ATGAATTGACGGCAGGCGTTGTCA
TAACACGAAATGACCGGGATTAAC -> AACACGAAATGACCGGGATTAACT
TGCCGTGGGCCGCTGATCGTGTTA -> GCCGTGGGCCGCTGATCGTGTTAG
CCGATCGCATATCCTAGCAGCGAC -> CGATCGCATATCCTAGCAGCGACC
CTCTGCTTAGATGTTACATCGGTA -> TCTGCTTAGATGTTACATCGGTAG
TGCCTCTCCAGGAGTTCGTTATGG -> GCCTCTCCAGGAGTTCGTTATGGA
CTTAGGACGGAAGTTTCCTATCTA -> TTAGGACGGAAGTTTCCTATCTAA
CGACTAATCCTCGGATGGCTCTCA -> GACTAATCCTCGGATGGCTCTCAA
AACGCTCGCATGGCGTGCAGGTGT -> ACGCTCGCATGGCGTGCAGGTGTA
AGCGACCAGGCGTCGCGACTCGTA -> GCGACCAGGCGTCGCGACTCGTAA
TAATACCTACTTCAAAACGACTTA -> AATACCTACTTCAAAACGACTTAG
GCGACGCAACAGCCGGTCTCCCTT -> CGACGCAACAGCCGGTCTCCCTTT
ACGATGGCTTGAACCTCTGCTTAG -> CGATGGCTTGAACCTCTGCTTAGA
GCGGGCACCACACGTGGATGCCCG -> CGGGCACCACACGTGGATGCCCGG
AGTAATAGTAGTGCAGGCGGTTGC -> GTAATAGTAGTGCAGGCGGTTGCG
CGTCTTAATACTGAAAGTGTCTGG -> GTCTTAATACTGAAAGTGTCTGGT
CACGACTAATCCTCGGATGGCTCT -> ACGACTAATCCTCGGATGGCTCTC
ATGAATTGACGGCAGGCGTTGTCA -> TGAATTGACGGCAGGCGTTGTCAT
TTGTGCCAAATGCTGCAGTCCATT -> TGTGCCAAATGCTGCAGTCCATTT
GTCGTTACTTGGTGGGAGCACGAC -> TCGTTACTTGGTGGGAGCACGACT
CTTTATTCAGTTAACACGAAATGA -> TTTATTCAGTTAACACGAAATGAC
CTTAATACCTACTTCAAAACGACT -> TTAATACCTACTTCAAAACGACTT
CCTCTGCTTAGATGTTACATCGGT -> CTCTGCTTAGATGTTACATCGGTA
CCTAGATTTCAACCATGACAGCAC -> CTAGATTTCAACCATGACAGCACG
AATAGCGGGCACCACACGTGGATG -> ATAGCGGGCACCACACGTGGATGC
TTAGATGTTACATCGGTAGAAGAC -> TAGATGTTACATCGGTAGAAGACT
AACCCTCACACCGGTGCACAGTGT -> ACCCTCACACCGGTGCACAGTGTT
CCTCACACCGGTGCACAGTGTTGA -> CTCACACCGGTGCACAGTGTTGAG
GCCCCAAGCCAAGGATGATAGCAA -> CCCCAAGCCAAGGATGATAGCAAC
CGACCTAAAAGAATATGCGTCCTT -> GACCTAAAAGAATATGCGTCCTTC
GAGAAAACACACGGCGATGAGGCG -> AGAAAACACACGGCGATGAGGCGT
TGACCACAAAGATGTCAGTTTTGA -> GACCACAAAGATGTCAGTTTTGAA
TTAGAGAAAACACACGGCGATGAG -> TAGAGAAAACACACGGCGATGAGG
CTGAAAGTGTCTGGTATCATAAAA -> TGAAAGTGTCTGGTATCATAAAAC
CCCGTCATAGTTACGAACGCTCGC -> CCGTCATAGTTACGAACGCTCGCA
GGGATAAGTTCGCATCGGGCGCCT -> GGATAAGTTCGCATCGGGCGCCTA
GGAATGGGCCGTTAACCTCTCGTC -> GAATGGGCCGTTAACCTCTCGTCT
AAGCTTGCTGGGCTCGAAGTATCG -> AGCTTGCTGGGCTCGAAGTATCGC
TTGGGGCAGACACGATCAAGTCAC -> TGGGGCAGACACGATCAAGTCACA
GTCCGTGATGCCTGGTAAGCAGTT -> TCCGTGATGCCTGGTAAGCAGTTT
GTTCGTTATGGATTCGTTATGTCG -> TTCGTTATGGATTCGTTATGTCGA
GTGCACAGTGTTGAGTGGGGACGA -> TGCACAGTGTTGAGTGGGGACGAA
TAGTATCGCAGGAGGTTTATCGCG -> AGTATCGCAGGAGGTTTATCGCGC
GGTAATTGGGCGCCCCAAGCCAAG -> GTAATTGGGCGCCCCAAGCCAAGG
GCCCCGATCGCATATCCTAGCAGC -> CCCCGATCGCATATCCTAGCAGCG
CCCGGTCGTCGAGTGACGTACTCA -> CCGGTCGTCGAGTGACGTACTCAA
TGTAAAGCGAAGGGGTGATGCGCT -> GTAAAGCGAAGGGGTGATGCGCTC
CGCTTAATTGCACGAAGCAGACAT -> GCTTAATTGCACGAAGCAGACATA
AAGTAGACTCCTCCAAAGCCTCCA -> AGTAGACTCCTCCAAAGCCTCCAC
GATTAACTCGTCTTAATACTGAAA -> ATTAACTCGTCTTAATACTGAAAG
TACTTGTCGTAACTACGCACCCCC -> ACTTGTCGTAACTACGCACCCCCA
GCCTCCACGCAGTTCGGAGCTTAA -> CCTCCACGCAGTTCGGAGCTTAAT
AGCCGAAACTTTATTCAGTTAACA -> GCCGAAACTTTATTCAGTTAACAC
TCGCTTAATTGCACGAAGCAGACA -> CGCTTAATTGCACGAAGCAGACAT
TATAATTTGCAGCTTATAATGCGA -> ATAATTTGCAGCTTATAATGCGAT
TTTCAACCATGACAGCACGGACTT -> TTCAACCATGACAGCACGGACTTA
GCACGAAGCAGACATAATGCACTC -> CACGAAGCAGACATAATGCACTCT
GACTCGTAAACGAAGGCTTCATTA -> ACTCGTAAACGAAGGCTTCATTAG
ATGACCGGGATTAACTCGTCTTAA -> TGACCGGGATTAACTCGTCTTAAT
TGTTAGTCGACGCCTGCCTCTCCA -> GTTAGTCGACGCCTGCCTCTCCAG
AGTATCGCACTAGTGTTTGGCGGG -> GTATCGCACTAGTGTTTGGCGGGA
GCGCCTAGAAGCATCCGTGACCAC -> CGCCTAGAAGCATCCGTGACCACA
GTTATGTCGAAACGATGGCTTGAA -> TTATGTCGAAACGATGGCTTGAAC
GCCTGTAAAGCGAAGGGGTGATGC -> CCTGTAAAGCGAAGGGGTGATGCG
AAGCTACGCTGAATAAACAGTCTT -> AGCTACGCTGAATAAACAGTCTTA
AAGAATCTGAGACGTTGTGACCGA -> AGAATCTGAGACGTTGTGACCGAC
ATCTGAGACGTTGTGACCGACCTA -> TCTGAGACGTTGTGACCGACCTAA
AGGCGTTGTCATGTCCCGCGTTCC -> GGCGTTGTCATGTCCCGCGTTCCC
GGCGGTTGCGGCCCGTAGCCTGAG -> GCGGTTGCGGCCCGTAGCCTGAGA
AAACCTAGTATCGCAGGAGGTTTA -> AACCTAGTATCGCAGGAGGTTTAT
GCCAAGGATGATAGCAACACCTGT -> CCAAGGATGATAGCAACACCTGTT
GTCCCGACCGCTACGTGCGGACCT -> TCCCGACCGCTACGTGCGGACCTA
CGGTCGTCGAGTGACGTACTCAAC -> GGTCGTCGAGTGACGTACTCAACT
TTCGCATCGGGCGCCTAGAAGCAT -> TCGCATCGGGCGCCTAGAAGCATC
TTGAGCATAGTGCGTCGAAGTAGA -> TGAGCATAGTGCGTCGAAGTAGAC
CTACCAACGACAACTCGGGGAGCC -> TACCAACGACAACTCGGGGAGCCA
CCATGTGCGGTTCCCTCCATAGGT -> CATGTGCGGTTCCCTCCATAGGTA
GTTTCCTATCTAATACGCTATATA -> TTTCCTATCTAATACGCTATATAA
GTAAGCATGATATACCATAGACTT -> TAAGCATGATATACCATAGACTTA
GTGCAGGTGTATAGCTCTGTTAGT -> TGCAGGTGTATAGCTCTGTTAGTC
ACTAATCCTCGGATGGCTCTCAAT -> CTAATCCTCGGATGGCTCTCAATA
ATGATATACCATAGACTTAGGACG -> TGATATACCATAGACTTAGGACGG
GCTACGTGCGGACCTAGTTCAGTA -> CTACGTGCGGACCTAGTTCAGTAA
CCTCCACGCAGTTCGGAGCTTAAT -> CTCCACGCAGTTCGGAGCTTAATA
GGCCGTTAACCTCTCGTCTGATGC -> GCCGTTAACCTCTCGTCTGATGCG
CTTGCGTCTTTCATGAATTGACGG -> TTGCGTCTTTCATGAATTGACGGC
TCAAAACGACTTAGAGGAATGGGC -> CAAAACGACTTAGAGGAATGGGCC
GTAACAAGTCGTGCCGTGGGCCGC -> TAACAAGTCGTGCCGTGGGCCGCT
GGGAGGGGTGTAAGCATGATATAC -> GGAGGGGTGTAAGCATGATATACC
CATCACCTTCACCATCCTCGAGTC -> ATCACCTTCACCATCCTCGAGTCC
CTGTTATAGGCTTCTAGAATCAAG -> TGTTATAGGCTTCTAGAATCAAGA
TAGAATCAAGAATCTGAGACGTTG -> AGAATCAAGAATCTGAGACGTTGT
ACGCAACAGCCGGTCTCCCTTTGT -> CGCAACAGCCGGTCTCCCTTTGTC
TGAATTGACGGCAGGCGTTGTCAT -> GAATTGACGGCAGGCGTTGTCATG
TGTTAGAGAAAACACACGGCGATG -> GTTAGAGAAAACACACGGCGATGA
CCGCTGATCGTGTTAGAGAAAACA -> CGCTGATCGTGTTAGAGAAAACAC
GAAGCATCCGTGACCACAAAGATG -> AAGCATCCGTGACCACAAAGATGT
ACTTTATTCAGTTAACACGAAATG -> CTTTATTCAGTTAACACGAAATGA
CTACGTGCGGACCTAGTTCAGTAA -> TACGTGCGGACCTAGTTCAGTAAC
AACAGCCGGTCTCCCTTTGTCGGC -> ACAGCCGGTCTCCCTTTGTCGGCA
AACACACGGCGATGAGGCGTCAGC -> ACACACGGCGATGAGGCGTCAGCC
AAACGATGGCTTGAACCTCTGCTT -> AACGATGGCTTGAACCTCTGCTTA
TGTCGAAACGATGGCTTGAACCTC -> GTCGAAACGATGGCTTGAACCTCT
CAGGCGTCGCGACTCGTAAACGAA -> AGGCGTCGCGACTCGTAAACGAAG
CGGATACTTGTCGTAACTACGCAC -> GGATACTTGTCGTAACTACGCACC
GCTTCTAGAATCAAGAATCTGAGA -> CTTCTAGAATCAAGAATCTGAGAC
TGCACGAAGCAGACATAATGCACT -> GCACGAAGCAGACATAATGCACTC
CCCTACTACCAACGACAACTCGGG -> CCTACTACCAACGACAACTCGGGG
GAATTGACGGCAGGCGTTGTCATG -> AATTGACGGCAGGCGTTGTCATGT
ACCGGGATTAACTCGTCTTAATAC -> CCGGGATTAACTCGTCTTAATACT
TTCAAAACGACTTAGAGGAATGGG -> TCAAAACGACTTAGAGGAATGGGC
ATGTCAGTTTTGAACCCTCACACC -> TGTCAGTTTTGAACCCTCACACCG
GACAGCGCCTGACCATCACCTTCA -> ACAGCGCCTGACCATCACCTTCAC
ATCAAGTCACAAAGGTATGACACC -> TCAAGTCACAAAGGTATGACACCA
ATGATAGCAACACCTGTTATAGGC -> TGATAGCAACACCTGTTATAGGCT
CGATCACGGATACTTGTCGTAACT -> GATCACGGATACTTGTCGTAACTA
TAAGCATGATATACCATAGACTTA -> AAGCATGATATACCATAGACTTAG
GTCGACGCCTGCCTCTCCAGGAGT -> TCGACGCCTGCCTCTCCAGGAGTT
GACGCCTGCCTCTCCAGGAGTTCG -> ACGCCTGCCTCTCCAGGAGTTCGT
ATGCCCGGTCGTCGAGTGACGTAC -> TGCCCGGTCGTCGAGTGACGTACT
CTGACACTGGAACGTCCGGTGACT -> TGACACTGGAACGTCCGGTGACTG
CAATATCCCGTCATAGTTACGAAC -> AATATCCCGTCATAGTTACGAACG
AGTTACGAACGCTCGCATGGCGTG -> GTTACGAACGCTCGCATGGCGTGC
TAATTGCACGAAGCAGACATAATG -> AATTGCACGAAGCAGACATAATGC
CCCAACAAACAGCCAACTCCCATG -> CCAACAAACAGCCAACTCCCATGT
TGCCCTAGATTTCAACCATGACAG -> GCCCTAGATTTCAACCATGACAGC
AAACAGCCAACTCCCATGTGCGGT -> AACAGCCAACTCCCATGTGCGGTT
GTTTTGAACCCTCACACCGGTGCA -> TTTTGAACCCTCACACCGGTGCAC
TCCACGCAGTTCGGAGCTTAATAC -> CCACGCAGTTCGGAGCTTAATACC
CAGTGCAGCAATATCCCGTCATAG -> AGTGCAGCAATATCCCGTCATAGT
ACAAAGGTATGACACCAAAAGAAG -> CAAAGGTATGACACCAAAAGAAGT
GAAAGAAAGCTACGCTGAATAAAC -> AAAGAAAGCTACGCTGAATAAACA
CTGTTAGTCGACGCCTGCCTCTCC -> TGTTAGTCGACGCCTGCCTCTCCA
CCGCGTTCCCGCGGGATGAGATAT -> CGCGTTCCCGCGGGATGAGATATT
GATATACCATAGACTTAGGACGGA -> ATATACCATAGACTTAGGACGGAA
CCCCAACAAACAGCCAACTCCCAT -> CCCAACAAACAGCCAACTCCCATG
TTAGTCGTTACTTGGTGGGAGCAC -> TAGTCGTTACTTGGTGGGAGCACG
CATCCTCGAGTCCGTGATGCCTGG -> ATCCTCGAGTCCGTGATGCCTGGT
TACGCTGAATAAACAGTCTTAACT -> ACGCTGAATAAACAGTCTTAACTT
GCCTGGTAAGCAGTTTGGGGCAGA -> CCTGGTAAGCAGTTTGGGGCAGAC
ATATTCCCGTTCGGTGGGCTTCGG -> TATTCCCGTTCGGTGGGCTTCGGG
GGCGTCGCGACTCGTAAACGAAGG -> GCGTCGCGACTCGTAAACGAAGGC
GCGGTTCCCTCCATAGGTACGCCC -> CGGTTCCCTCCATAGGTACGCCCC
TATACCATAGACTTAGGACGGAAG -> ATACCATAGACTTAGGACGGAAGT
GAATAAACAGTCTTAACTTATCGA -> AATAAACAGTCTTAACTTATCGAG
TGAGAAAGAAAGCTACGCTGAATA -> GAGAAAGAAAGCTACGCTGAATAA
CATCGGTAGAAGACTGTTTTCCGT -> ATCGGTAGAAGACTGTTTTCCGTC
CTGATCGTGTTAGAGAAAACACAC -> TGATCGTGTTAGAGAAAACACACG
CATGTCTAAGCTTGCTGGGCTCGA -> ATGTCTAAGCTTGCTGGGCTCGAA
ACAGTGTTGAGTGGGGACGAAAAT -> CAGTGTTGAGTGGGGACGAAAATG
GTTGAGTGGGGACGAAAATGGCAC -> TTGAGTGGGGACGAAAATGGCACT
AGTTTTGAACCCTCACACCGGTGC -> GTTTTGAACCCTCACACCGGTGCA
CTGCAGTCCATTTGCTTTGGAGGT -> TGCAGTCCATTTGCTTTGGAGGTT
GCCTAGAAGCATCCGTGACCACAA -> CCTAGAAGCATCCGTGACCACAAA
ATGTCCCGCGTTCCCGCGGGATGA -> TGTCCCGCGTTCCCGCGGGATGAG
TTGCTGGGCTCGAAGTATCGCACT -> TGCTGGGCTCGAAGTATCGCACTA
GCCAACTCCCATGTGCGGTTCCCT -> CCAACTCCCATGTGCGGTTCCCTC
TGCAGGTGTATAGCTCTGTTAGTC -> GCAGGTGTATAGCTCTGTTAGTCG
CTCGCTTAATTGCACGAAGCAGAC -> TCGCTTAATTGCACGAAGCAGACA
CTGAATAAACAGTCTTAACTTATC -> TGAATAAACAGTCTTAACTTATCG
AATGCTGCAGTCCATTTGCTTTGG -> ATGCTGCAGTCCATTTGCTTTGGA
TTCAGTTAACACGAAATGACCGGG -> TCAGTTAACACGAAATGACCGGGA
CTCCGTCTGACACTGGAACGTCCG -> TCCGTCTGACACTGGAACGTCCGG
GCGGACCTAGTTCAGTAACAAGTC -> CGGACCTAGTTCAGTAACAAGTCG
AAACGAAGGCTTCATTAGTCGTTA -> AACGAAGGCTTCATTAGTCGTTAC
AGGTATGACACCAAAAGAAGTTGA -> GGTATGACACCAAAAGAAGTTGAG
CGGGCACCACACGTGGATGCCCGG -> GGGCACCACACGTGGATGCCCGGT
AATGGGCCGTTAACCTCTCGTCTG -> ATGGGCCGTTAACCTCTCGTCTGA
ACCAACGACAACTCGGGGAGCCAC -> CCAACGACAACTCGGGGAGCCACA
TGGCACTGCCCTAGATTTCAACCA -> GGCACTGCCCTAGATTTCAACCAT
CTTAATACTGAAAGTGTCTGGTAT -> TTAATACTGAAAGTGTCTGGTATC
CCTCTCGTCTGATGCGCACTTTCA -> CTCTCGTCTGATGCGCACTTTCAG
AATAGTAGTGCAGGCGGTTGCGGC -> ATAGTAGTGCAGGCGGTTGCGGCC
CTAATCCTCGGATGGCTCTCAATA -> TAATCCTCGGATGGCTCTCAATAT
ATGTGCGGTTCCCTCCATAGGTAC -> TGTGCGGTTCCCTCCATAGGTACG
AACGTCCGGTGACTGTTATGCCTC -> ACGTCCGGTGACTGTTATGCCTCT
TTCAACCATGACAGCACGGACTTA -> TCAACCATGACAGCACGGACTTAG
ACCTCTCGTCTGATGCGCACTTTC -> CCTCTCGTCTGATGCGCACTTTCA
GATGTCAGTTTTGAACCCTCACAC -> ATGTCAGTTTTGAACCCTCACACC
CCCTTATGACTCAAACAGCGAAGG -> CCTTATGACTCAAACAGCGAAGGA
CGGTAATTGGGCGCCCCAAGCCAA -> GGTAATTGGGCGCCCCAAGCCAAG
GTCATGTCCCGCGTTCCCGCGGGA -> TCATGTCCCGCGTTCCCGCGGGAT
GCAGGAGGTTTATCGCGCCAAATA -> CAGGAGGTTTATCGCGCCAAATAG
TTGCGGCCCGTAGCCTGAGAAAGA -> TGCGGCCCGTAGCCTGAGAAAGAA
TGTCCCTTATGACTCAAACAGCGA -> GTCCCTTATGACTCAAACAGCGAA
AGACTCCTCCAAAGCCTCCACGCA -> GACTCCTCCAAAGCCTCCACGCAG
TTAACCCGATGGAACTTGTCCCTT -> TAACCCGATGGAACTTGTCCCTTA
GTCGGCATGTCTAAGCTTGCTGGG -> TCGGCATGTCTAAGCTTGCTGGGC
GAGTTCTGGGATAAGTTCGCATCG -> AGTTCTGGGATAAGTTCGCATCGG
TGCGGACCTAGTTCAGTAACAAGT -> GCGGACCTAGTTCAGTAACAAGTC
AATTTGCAGCTTATAATGCGATCA -> ATTTGCAGCTTATAATGCGATCAC
TATGACTCAAACAGCGAAGGATAA -> ATGACTCAAACAGCGAAGGATAAG
GCAACACCTGTTATAGGCTTCTAG -> CAACACCTGTTATAGGCTTCTAGA
CCCGACCGCTACGTGCGGACCTAG -> CCGACCGCTACGTGCGGACCTAGT
TAAACGAAGGCTTCATTAGTCGTT -> AAACGAAGGCTTCATTAGTCGTTA
CATGGCGTGCAGGTGTATAGCTCT -> ATGGCGTGCAGGTGTATAGCTCTG
ATAGCGGGCACCACACGTGGATGC -> TAGCGGGCACCACACGTGGATGCC
CTAAAAGAATATGCGTCCTTCTGT -> TAAAAGAATATGCGTCCTTCTGTG
AGTGACGTACTCAACTAGACAGCG -> GTGACGTACTCAACTAGACAGCGC
AAGAAGTTGAGTTCTGGGATAAGT -> AGAAGTTGAGTTCTGGGATAAGTT
TTCCCGCGGGATGAGATATTTCGG -> TCCCGCGGGATGAGATATTTCGGA
TTGCCTGTAAAGCGAAGGGGTGAT -> TGCCTGTAAAGCGAAGGGGTGATG
GAAGACTGTTTTCCGTCGCTGTCT -> AAGACTGTTTTCCGTCGCTGTCTT
TGGCAAGTAATAGTAGTGCAGGCG -> GGCAAGTAATAGTAGTGCAGGCGG
TACCGAGTGTTAACCCGATGGAAC -> ACCGAGTGTTAACCCGATGGAACT
AGGTTTTGCCTGTAAAGCGAAGGG -> GGTTTTGCCTGTAAAGCGAAGGGG
GCGCTCGATTAGTTGAGCATAGTG -> CGCTCGATTAGTTGAGCATAGTGC
GTGTATAGCTCTGTTAGTCGACGC -> TGTATAGCTCTGTTAGTCGACGCC
CGTAACTACGCACCCCCAACAAAC -> GTAACTACGCACCCCCAACAAACA
TGACACTGGAACGTCCGGTGACTG -> GACACTGGAACGTCCGGTGACTGT
TGCCTCTTGCGTCTTTCATGAATT -> GCCTCTTGCGTCTTTCATGAATTG
TCGTGTTAGAGAAAACACACGGCG -> CGTGTTAGAGAAAACACACGGCGA
GCCTGCGTATCAGTCCCGACCGCT -> CCTGCGTATCAGTCCCGACCGCTA
GATATTTCGGATTTGTGCCAAATG -> ATATTTCGGATTTGTGCCAAATGC
GGGCACCACACGTGGATGCCCGGT -> GGCACCACACGTGGATGCCCGGTC
GACGAAAATGGCACTGCCCTAGAT -> ACGAAAATGGCACTGCCCTAGATT
AAGTTTCCTATCTAATACGCTATA -> AGTTTCCTATCTAATACGCTATAT
CGCCCCAAGCCAAGGATGATAGCA -> GCCCCAAGCCAAGGATGATAGCAA
CCATAGACTTAGGACGGAAGTTTC -> CATAGACTTAGGACGGAAGTTTCC
CCATGACAGCACGGACTTAGCCTG -> CATGACAGCACGGACTTAGCCTGC
TATAATGCGATCACGGATACTTGT -> ATAATGCGATCACGGATACTTGTC
AGCCAACTCCCATGTGCGGTTCCC -> GCCAACTCCCATGTGCGGTTCCCT
CATGAGAAACCTAGTATCGCAGGA -> ATGAGAAACCTAGTATCGCAGGAG
CACCCCCAACAAACAGCCAACTCC -> ACCCCCAACAAACAGCCAACTCCC
TGCCAAATGCTGCAGTCCATTTGC -> GCCAAATGCTGCAGTCCATTTGCT
TCCTCCAAAGCCTCCACGCAGTTC -> CCTCCAAAGCCTCCACGCAGTTCG
ATATAATTTGCAGCTTATAATGCG -> TATAATTTGCAGCTTATAATGCGA
TACTCAACTAGACAGCGCCTGACC -> ACTCAACTAGACAGCGCCTGACCA
GAGAAACCTAGTATCGCAGGAGGT -> AGAAACCTAGTATCGCAGGAGGTT
ACCTCTGCTTAGATGTTACATCGG -> CCTCTGCTTAGATGTTACATCGGT
GTGACTGTTATGCCTCTTGCGTCT -> TGACTGTTATGCCTCTTGCGTCTT
TGAGTTCTGGGATAAGTTCGCATC -> GAGTTCTGGGATAAGTTCGCATCG
CTTAGAGGAATGGGCCGTTAACCT -> TTAGAGGAATGGGCCGTTAACCTC
CGACGCAACAGCCGGTCTCCCTTT -> GACGCAACAGCCGGTCTCCCTTTG
ACCCCCAACAAACAGCCAACTCCC -> CCCCCAACAAACAGCCAACTCCCA
CCATCCTCGAGTCCGTGATGCCTG -> CATCCTCGAGTCCGTGATGCCTGG
CGTCATAGTTACGAACGCTCGCAT -> GTCATAGTTACGAACGCTCGCATG
CCCTCGCTTAATTGCACGAAGCAG -> CCTCGCTTAATTGCACGAAGCAGA
AATGCACTCTGGAGCACAATACCG -> ATGCACTCTGGAGCACAATACCGA
TAACTACGCACCCCCAACAAACAG -> AACTACGCACCCCCAACAAACAGC
TACTGAAAGTGTCTGGTATCATAA -> ACTGAAAGTGTCTGGTATCATAAA
CTGGAACGTCCGGTGACTGTTATG -> TGGAACGTCCGGTGACTGTTATGC
AATCCTCGGATGGCTCTCAATATT -> ATCCTCGGATGGCTCTCAATATTC
GCGCCTGACCATCACCTTCACCAT -> CGCCTGACCATCACCTTCACCATC
CATCCCTACTACCAACGACAACTC -> ATCCCTACTACCAACGACAACTCG
GTCGAAACGATGGCTTGAACCTCT -> TCGAAACGATGGCTTGAACCTCTG
GGTGTATAGCTCTGTTAGTCGACG -> GTGTATAGCTCTGTTAGTCGACGC
AGGAGGTTTATCGCGCCAAATAGC -> GGAGGTTTATCGCGCCAAATAGCG
CGGACCTAGTTCAGTAACAAGTCG -> GGACCTAGTTCAGTAACAAGTCGT
AGCGCCTGACCATCACCTTCACCA -> GCGCCTGACCATCACCTTCACCAT
TCCCTACTACCAACGACAACTCGG -> CCCTACTACCAACGACAACTCGGG
GGAGTTCGTTATGGATTCGTTATG -> GAGTTCGTTATGGATTCGTTATGT
CGGTAGAAGACTGTTTTCCGTCGC -> GGTAGAAGACTGTTTTCCGTCGCT
CTACTTCAAAACGACTTAGAGGAA -> TACTTCAAAACGACTTAGAGGAAT
AATAAACAGTCTTAACTTATCGAG -> ATAAACAGTCTTAACTTATCGAGC
AAGTTCGCATCGGGCGCCTAGAAG -> AGTTCGCATCGGGCGCCTAGAAGC
TCACCTTCACCATCCTCGAGTCCG -> CACCTTCACCATCCTCGAGTCCGT
CTATCTAATACGCTATATAATTTG -> TATCTAATACGCTATATAATTTGC
GCACTAGTGTTTGGCGGGAGGGGT -> CACTAGTGTTTGGCGGGAGGGGTG
GGCTTCGGGTTCTCCGTCTGACAC -> GCTTCGGGTTCTCCGTCTGACACT
AAGGGGTGATGCGCTCGATTAGTT -> AGGGGTGATGCGCTCGATTAGTTG
AGTTGAGCATAGTGCGTCGAAGTA -> GTTGAGCATAGTGCGTCGAAGTAG
TTTGTGCCAAATGCTGCAGTCCAT -> TTGTGCCAAATGCTGCAGTCCATT
GTGACGTACTCAACTAGACAGCGC -> TGACGTACTCAACTAGACAGCGCC
TAATTGGGCGCCCCAAGCCAAGGA -> AATTGGGCGCCCCAAGCCAAGGAT
CAAGCCAAGGATGATAGCAACACC -> AAGCCAAGGATGATAGCAACACCT
AGCCGGTCTCCCTTTGTCGGCATG -> GCCGGTCTCCCTTTGTCGGCATGT
TCTGCTTAGATGTTACATCGGTAG -> CTGCTTAGATGTTACATCGGTAGA
ATAGTAGTGCAGGCGGTTGCGGCC -> TAGTAGTGCAGGCGGTTGCGGCCC
TTGACGGCAGGCGTTGTCATGTCC -> TGACGGCAGGCGTTGTCATGTCCC
AATGGCACTGCCCTAGATTTCAAC -> ATGGCACTGCCCTAGATTTCAACC
CTCGGTAATTGGGCGCCCCAAGCC -> TCGGTAATTGGGCGCCCCAAGCCA
CTATATAATTTGCAGCTTATAATG -> TATATAATTTGCAGCTTATAATGC
CGTATCAGTCCCGACCGCTACGTG -> GTATCAGTCCCGACCGCTACGTGC
GAAGCAGACATAATGCACTCTGGA -> AAGCAGACATAATGCACTCTGGAG
CTCTGTTAGTCGACGCCTGCCTCT -> TCTGTTAGTCGACGCCTGCCTCTC
GCTCGAAGTATCGCACTAGTGTTT -> CTCGAAGTATCGCACTAGTGTTTG
ACGTACTCAACTAGACAGCGCCTG -> CGTACTCAACTAGACAGCGCCTGA
TGCCTGGTAAGCAGTTTGGGGCAG -> GCCTGGTAAGCAGTTTGGGGCAGA
TGCTTAGATGTTACATCGGTAGAA -> GCTTAGATGTTACATCGGTAGAAG
CCTCTCCAGGAGTTCGTTATGGAT -> CTCTCCAGGAGTTCGTTATGGATT
TTGAGTTCTGGGATAAGTTCGCAT -> TGAGTTCTGGGATAAGTTCGCATC
ATCCCGTCATAGTTACGAACGCTC -> TCCCGTCATAGTTACGAACGCTCG
GATTTCAACCATGACAGCACGGAC -> ATTTCAACCATGACAGCACGGACT
GCAGGCGTTGTCATGTCCCGCGTT -> CAGGCGTTGTCATGTCCCGCGTTC
TAGAAGACTGTTTTCCGTCGCTGT -> AGAAGACTGTTTTCCGTCGCTGTC
GTCCCTTATGACTCAAACAGCGAA -> TCCCTTATGACTCAAACAGCGAAG
TCTGAGACGTTGTGACCGACCTAA -> CTGAGACGTTGTGACCGACCTAAA
ACTTAGAGGAATGGGCCGTTAACC -> CTTAGAGGAATGGGCCGTTAACCT
AATGCGATCACGGATACTTGTCGT -> ATGCGATCACGGATACTTGTCGTA
ATGTCGAAACGATGGCTTGAACCT -> TGTCGAAACGATGGCTTGAACCTC
AGTTTGGGGCAGACACGATCAAGT -> GTTTGGGGCAGACACGATCAAGTC
ATAGTGCGTCGAAGTAGACTCCTC -> TAGTGCGTCGAAGTAGACTCCTCC
GCCACATGAGAAACCTAGTATCGC -> CCACATGAGAAACCTAGTATCGCA
CGCTCGCATGGCGTGCAGGTGTAT -> GCTCGCATGGCGTGCAGGTGTATA
ATAATTTGCAGCTTATAATGCGAT -> TAATTTGCAGCTTATAATGCGATC
ACTGTTTTCCGTCGCTGTCTTCTG -> CTGTTTTCCGTCGCTGTCTTCTGG
TCCCGACCGCTACGTGCGGACCTA -> CCCGACCGCTACGTGCGGACCTAG
CACGAAGCAGACATAATGCACTCT -> ACGAAGCAGACATAATGCACTCTG
CCAGGCGTCGCGACTCGTAAACGA -> CAGGCGTCGCGACTCGTAAACGAA
CCATTTGCTTTGGAGGTTTTGCCT -> CATTTGCTTTGGAGGTTTTGCCTG
TCCGTCTGACACTGGAACGTCCGG -> CCGTCTGACACTGGAACGTCCGGT
CTCAAACAGCGAAGGATAAGCGAC -> TCAAACAGCGAAGGATAAGCGACG
CTTCGGGTTCTCCGTCTGACACTG -> TTCGGGTTCTCCGTCTGACACTGG
GGTTGCGGCCCGTAGCCTGAGAAA -> GTTGCGGCCCGTAGCCTGAGAAAG
ACATAATGCACTCTGGAGCACAAT -> CATAATGCACTCTGGAGCACAATA
TCCGTCGCTGTCTTCTGGCAAGTA -> CCGTCGCTGTCTTCTGGCAAGTAA
GCCGAAACTTTATTCAGTTAACAC -> CCGAAACTTTATTCAGTTAACACG
CCAAGGATGATAGCAACACCTGTT -> CAAGGATGATAGCAACACCTGTTA
AGACTGTTTTCCGTCGCTGTCTTC -> GACTGTTTTCCGTCGCTGTCTTCT
GCATGATATACCATAGACTTAGGA -> CATGATATACCATAGACTTAGGAC
TCCTCGGATGGCTCTCAATATTCC -> CCTCGGATGGCTCTCAATATTCCC
TTTCCGTCGCTGTCTTCTGGCAAG -> TTCCGTCGCTGTCTTCTGGCAAGT
AGTCGTTACTTGGTGGGAGCACGA -> GTCGTTACTTGGTGGGAGCACGAC
GCACCACACGTGGATGCCCGGTCG -> CACCACACGTGGATGCCCGGTCGT
CAAAGCCTCCACGCAGTTCGGAGC -> AAAGCCTCCACGCAGTTCGGAGCT
CGGTCTCCCTTTGTCGGCATGTCT -> GGTCTCCCTTTGTCGGCATGTCTA
GCTTGCTGGGCTCGAAGTATCGCA -> CTTGCTGGGCTCGAAGTATCGCAC
GAGTTCGTTATGGATTCGTTATGT -> AGTTCGTTATGGATTCGTTATGTC
AGAAAACACACGGCGATGAGGCGT -> GAAAACACACGGCGATGAGGCGTC
GGGACGAAAATGGCACTGCCCTAG -> GGACGAAAATGGCACTGCCCTAGA
CCAACTCCCATGTGCGGTTCCCTC -> CAACTCCCATGTGCGGTTCCCTCC
CAGACATAATGCACTCTGGAGCAC -> AGACATAATGCACTCTGGAGCACA
GGGGAGCCACATGAGAAACCTAGT -> GGGAGCCACATGAGAAACCTAGTA
ACACGGCGATGAGGCGTCAGCCGA -> CACGGCGATGAGGCGTCAGCCGAA
TAAGCGACGCAACAGCCGGTCTCC -> AAGCGACGCAACAGCCGGTCTCCC
GTCTTCTGGCAAGTAATAGTAGTG -> TCTTCTGGCAAGTAATAGTAGTGC
ACGGCGATGAGGCGTCAGCCGAAA -> CGGCGATGAGGCGTCAGCCGAAAC
GGTACGCCCCGATCGCATATCCTA -> GTACGCCCCGATCGCATATCCTAG
ATATCCTAGCAGCGACCAGGCGTC -> TATCCTAGCAGCGACCAGGCGTCG
GTCTCCCTTTGTCGGCATGTCTAA -> TCTCCCTTTGTCGGCATGTCTAAG
TAGAGGAATGGGCCGTTAACCTCT -> AGAGGAATGGGCCGTTAACCTCTC
TAATCCTCGGATGGCTCTCAATAT -> AATCCTCGGATGGCTCTCAATATT
AAAAGAAGTTGAGTTCTGGGATAA -> AAAGAAGTTGAGTTCTGGGATAAG
GTTAGTCGACGCCTGCCTCTCCAG -> TTAGTCGACGCCTGCCTCTCCAGG
GGCTCTCAATATTCCCGTTCGGTG -> GCTCTCAATATTCCCGTTCGGTGG
CTCTTGCGTCTTTCATGAATTGAC -> TCTTGCGTCTTTCATGAATTGACG
CACCGGTGCACAGTGTTGAGTGGG -> ACCGGTGCACAGTGTTGAGTGGGG
TGACGTACTCAACTAGACAGCGCC -> GACGTACTCAACTAGACAGCGCCT
GCCCTAGATTTCAACCATGACAGC -> CCCTAGATTTCAACCATGACAGCA
TTCTGGGATAAGTTCGCATCGGGC -> TCTGGGATAAGTTCGCATCGGGCG
CAGTTTGGGGCAGACACGATCAAG -> AGTTTGGGGCAGACACGATCAAGT
GGGATTAACTCGTCTTAATACTGA -> GGATTAACTCGTCTTAATACTGAA
ACTAGTGTTTGGCGGGAGGGGTGT -> CTAGTGTTTGGCGGGAGGGGTGTA
CCCTCACACCGGTGCACAGTGTTG -> CCTCACACCGGTGCACAGTGTTGA
TATCCTAGCAGCGACCAGGCGTCG -> ATCCTAGCAGCGACCAGGCGTCGC
GAGCCACATGAGAAACCTAGTATC -> AGCCACATGAGAAACCTAGTATCG
CTTAATTGCACGAAGCAGACATAA -> TTAATTGCACGAAGCAGACATAAT
CCCCCAACAAACAGCCAACTCCCA -> CCCCAACAAACAGCCAACTCCCAT
TGGAACGTCCGGTGACTGTTATGC -> GGAACGTCCGGTGACTGTTATGCC
ATACCATAGACTTAGGACGGAAGT -> TACCATAGACTTAGGACGGAAGTT
ACTGCCCTAGATTTCAACCATGAC -> CTGCCCTAGATTTCAACCATGACA
GTCTGATGCGCACTTTCAGTAGAC -> TCTGATGCGCACTTTCAGTAGACA
TTGCACGAAGCAGACATAATGCAC -> TGCACGAAGCAGACATAATGCACT
TCGATTAGTTGAGCATAGTGCGTC -> CGATTAGTTGAGCATAGTGCGTCG
GAATCAAGAATCTGAGACGTTGTG -> AATCAAGAATCTGAGACGTTGTGA
TTGTCATGTCCCGCGTTCCCGCGG -> TGTCATGTCCCGCGTTCCCGCGGG
CGAAGGGGTGATGCGCTCGATTAG -> GAAGGGGTGATGCGCTCGATTAGT
CCTTCTGTGCCCCGGCCCTCGCTT -> CTTCTGTGCCCCGGCCCTCGCTTA
ACTCGTCTTAATACTGAAAGTGTC -> CTCGTCTTAATACTGAAAGTGTCT
TATCATAAAACAGTGCAGCAATAT -> ATCATAAAACAGTGCAGCAATATC
GGTTCCCTCCATAGGTACGCCCCG -> GTTCCCTCCATAGGTACGCCCCGA
ATAAGTTCGCATCGGGCGCCTAGA -> TAAGTTCGCATCGGGCGCCTAGAA
TGCAGGCGGTTGCGGCCCGTAGCC -> GCAGGCGGTTGCGGCCCGTAGCCT
ACTCGGGGAGCCACATGAGAAACC -> CTCGGGGAGCCACATGAGAAACCT
CTTGCTGGGCTCGAAGTATCGCAC -> TTGCTGGGCTCGAAGTATCGCACT
GACCGCTACGTGCGGACCTAGTTC -> ACCGCTACGTGCGGACCTAGTTCA
GCGTCGCGACTCGTAAACGAAGGC -> CGTCGCGACTCGTAAACGAAGGCT
AAGCATGATATACCATAGACTTAG -> AGCATGATATACCATAGACTTAGG
AGTTCTGGGATAAGTTCGCATCGG -> GTTCTGGGATAAGTTCGCATCGGG
TGTTATAGGCTTCTAGAATCAAGA -> GTTATAGGCTTCTAGAATCAAGAA
CAAGTCACAAAGGTATGACACCAA -> AAGTCACAAAGGTATGACACCAAA
CAGTCCATTTGCTTTGGAGGTTTT -> AGTCCATTTGCTTTGGAGGTTTTG
TGGCGTGCAGGTGTATAGCTCTGT -> GGCGTGCAGGTGTATAGCTCTGTT
CCTCGGATGGCTCTCAATATTCCC -> CTCGGATGGCTCTCAATATTCCCG
CGTCTGATGCGCACTTTCAGTAGA -> GTCTGATGCGCACTTTCAGTAGAC
GCCAAATAGCGGGCACCACACGTG -> CCAAATAGCGGGCACCACACGTGG
CCGCTACGTGCGGACCTAGTTCAG -> CGCTACGTGCGGACCTAGTTCAGT
CTGGCAAGTAATAGTAGTGCAGGC -> TGGCAAGTAATAGTAGTGCAGGCG
ACTCTGGAGCACAATACCGAGTGT -> CTCTGGAGCACAATACCGAGTGTT
ATTGCACGAAGCAGACATAATGCA -> TTGCACGAAGCAGACATAATGCAC
TCTAGAATCAAGAATCTGAGACGT -> CTAGAATCAAGAATCTGAGACGTT
ACTTAGGACGGAAGTTTCCTATCT -> CTTAGGACGGAAGTTTCCTATCTA
AGACACGATCAAGTCACAAAGGTA -> GACACGATCAAGTCACAAAGGTAT
TTAGGACGGAAGTTTCCTATCTAA -> TAGGACGGAAGTTTCCTATCTAAT
TCAGCCGAAACTTTATTCAGTTAA -> CAGCCGAAACTTTATTCAGTTAAC
TCGGTAGAAGACTGTTTTCCGTCG -> CGGTAGAAGACTGTTTTCCGTCGC
CTGCTTAGATGTTACATCGGTAGA -> TGCTTAGATGTTACATCGGTAGAA
TGACCGACCTAAAAGAATATGCGT -> GACCGACCTAAAAGAATATGCGTC
ACCGAGTGTTAACCCGATGGAACT -> CCGAGTGTTAACCCGATGGAACTT
GGACGAAAATGGCACTGCCCTAGA -> GACGAAAATGGCACTGCCCTAGAT
CCTCCAAAGCCTCCACGCAGTTCG -> CTCCAAAGCCTCCACGCAGTTCGG
TCGAAACGATGGCTTGAACCTCTG -> CGAAACGATGGCTTGAACCTCTGC
CGAAAATGGCACTGCCCTAGATTT -> GAAAATGGCACTGCCCTAGATTTC
CTGGTAAGCAGTTTGGGGCAGACA -> TGGTAAGCAGTTTGGGGCAGACAC
GGATTCGTTATGTCGAAACGATGG -> GATTCGTTATGTCGAAACGATGGC
CCTACTACCAACGACAACTCGGGG -> CTACTACCAACGACAACTCGGGGA
CGATGGCTTGAACCTCTGCTTAGA -> GATGGCTTGAACCTCTGCTTAGAT
GTTATAGGCTTCTAGAATCAAGAA -> TTATAGGCTTCTAGAATCAAGAAT
ATCGTGTTAGAGAAAACACACGGC -> TCGTGTTAGAGAAAACACACGGCG
CTCCATAGGTACGCCCCGATCGCA -> TCCATAGGTACGCCCCGATCGCAT
GAACCTCTGCTTAGATGTTACATC -> AACCTCTGCTTAGATGTTACATCG
TCATAAAACAGTGCAGCAATATCC -> CATAAAACAGTGCAGCAATATCCC
CGCAGTTCGGAGCTTAATACCTAC -> GCAGTTCGGAGCTTAATACCTACT
TTGGAGGTTTTGCCTGTAAAGCGA -> TGGAGGTTTTGCCTGTAAAGCGAA
ATTTGTGCCAAATGCTGCAGTCCA -> TTTGTGCCAAATGCTGCAGTCCAT
CCGTCGCTGTCTTCTGGCAAGTAA -> CGTCGCTGTCTTCTGGCAAGTAAT
CCGACCGCTACGTGCGGACCTAGT -> CGACCGCTACGTGCGGACCTAGTT
TCGCTGTCTTCTGGCAAGTAATAG -> CGCTGTCTTCTGGCAAGTAATAGT
GCTACGCTGAATAAACAGTCTTAA -> CTACGCTGAATAAACAGTCTTAAC
CGCGCCAAATAGCGGGCACCACAC -> GCGCCAAATAGCGGGCACCACACG
TGCGGCCCGTAGCCTGAGAAAGAA -> GCGGCCCGTAGCCTGAGAAAGAAA
GAAATGACCGGGATTAACTCGTCT -> AAATGACCGGGATTAACTCGTCTT
CAAACAGCCAACTCCCATGTGCGG -> AAACAGCCAACTCCCATGTGCGGT
CCAAAGCCTCCACGCAGTTCGGAG -> CAAAGCCTCCACGCAGTTCGGAGC
CCTAGTATCGCAGGAGGTTTATCG -> CTAGTATCGCAGGAGGTTTATCGC
CACTGCCCTAGATTTCAACCATGA -> ACTGCCCTAGATTTCAACCATGAC
CCGTTCGGTGGGCTTCGGGTTCTC -> CGTTCGGTGGGCTTCGGGTTCTCC
ACCTAGTATCGCAGGAGGTTTATC -> CCTAGTATCGCAGGAGGTTTATCG
TAAAACAGTGCAGCAATATCCCGT -> AAAACAGTGCAGCAATATCCCGTC
GGTTCTCCGTCTGACACTGGAACG -> GTTCTCCGTCTGACACTGGAACGT
CCGAGTGTTAACCCGATGGAACTT -> CGAGTGTTAACCCGATGGAACTTG
GTAAAGCGAAGGGGTGATGCGCTC -> TAAAGCGAAGGGGTGATGCGCTCG
ACACGATCAAGTCACAAAGGTATG -> CACGATCAAGTCACAAAGGTATGA
ATGGCTTGAACCTCTGCTTAGATG -> TGGCTTGAACCTCTGCTTAGATGT
ACTTGTCGTAACTACGCACCCCCA -> CTTGTCGTAACTACGCACCCCCAA
TGTTAACCCGATGGAACTTGTCCC -> GTTAACCCGATGGAACTTGTCCCT
ACAGCACGGACTTAGCCTGCGTAT -> CAGCACGGACTTAGCCTGCGTATC
ATTCAGTTAACACGAAATGACCGG -> TTCAGTTAACACGAAATGACCGGG
CGATTAGTTGAGCATAGTGCGTCG -> GATTAGTTGAGCATAGTGCGTCGA
CAACTCGGGGAGCCACATGAGAAA -> AACTCGGGGAGCCACATGAGAAAC
GTGCAGGCGGTTGCGGCCCGTAGC -> TGCAGGCGGTTGCGGCCCGTAGCC
ACGAAGGCTTCATTAGTCGTTACT -> CGAAGGCTTCATTAGTCGTTACTT
TACGCCCCGATCGCATATCCTAGC -> ACGCCCCGATCGCATATCCTAGCA
GTATAGCTCTGTTAGTCGACGCCT -> TATAGCTCTGTTAGTCGACGCCTG
ATTTCGGATTTGTGCCAAATGCTG -> TTTCGGATTTGTGCCAAATGCTGC
ATCACCTTCACCATCCTCGAGTCC -> TCACCTTCACCATCCTCGAGTCCG
GCTCTGTTAGTCGACGCCTGCCTC -> CTCTGTTAGTCGACGCCTGCCTCT
GGCGATGAGGCGTCAGCCGAAACT -> GCGATGAGGCGTCAGCCGAAACTT
TCGTCTGATGCGCACTTTCAGTAG -> CGTCTGATGCGCACTTTCAGTAGA
GGATAAGTTCGCATCGGGCGCCTA -> GATAAGTTCGCATCGGGCGCCTAG
GAGGTTTATCGCGCCAAATAGCGG -> AGGTTTATCGCGCCAAATAGCGGG
GTGTTAACCCGATGGAACTTGTCC -> TGTTAACCCGATGGAACTTGTCCC
CTCTCGTCTGATGCGCACTTTCAG -> TCTCGTCTGATGCGCACTTTCAGT
GATCAAGTCACAAAGGTATGACAC -> ATCAAGTCACAAAGGTATGACACC
GTGACCGACCTAAAAGAATATGCG -> TGACCGACCTAAAAGAATATGCGT
AGCCAAGGATGATAGCAACACCTG -> GCCAAGGATGATAGCAACACCTGT
GATGGAACTTGTCCCTTATGACTC -> ATGGAACTTGTCCCTTATGACTCA
CACAAAGGTATGACACCAAAAGAA -> ACAAAGGTATGACACCAAAAGAAG
GCTGGGCTCGAAGTATCGCACTAG -> CTGGGCTCGAAGTATCGCACTAGT
GTTTATCGCGCCAAATAGCGGGCA -> TTTATCGCGCCAAATAGCGGGCAC
ACTGTTATGCCTCTTGCGTCTTTC -> CTGTTATGCCTCTTGCGTCTTTCA
CTTAGCCTGCGTATCAGTCCCGAC -> TTAGCCTGCGTATCAGTCCCGACC
GTCGTGCCGTGGGCCGCTGATCGT -> TCGTGCCGTGGGCCGCTGATCGTG
CAAGAATCTGAGACGTTGTGACCG -> AAGAATCTGAGACGTTGTGACCGA
TAAAAGAATATGCGTCCTTCTGTG -> AAAAGAATATGCGTCCTTCTGTGC
CTGTGCCCCGGCCCTCGCTTAATT -> TGTGCCCCGGCCCTCGCTTAATTG
TATGCCTCTTGCGTCTTTCATGAA -> ATGCCTCTTGCGTCTTTCATGAAT
GTTAACACGAAATGACCGGGATTA -> TTAACACGAAATGACCGGGATTAA
GCAGCAATATCCCGTCATAGTTAC -> CAGCAATATCCCGTCATAGTTACG
TAAACAGTCTTAACTTATCGAGCA -> AAACAGTCTTAACTTATCGAGCAT
GCTTAATACCTACTTCAAAACGAC -> CTTAATACCTACTTCAAAACGACT
GCTTCATTAGTCGTTACTTGGTGG -> CTTCATTAGTCGTTACTTGGTGGG
TCTTTCATGAATTGACGGCAGGCG -> CTTTCATGAATTGACGGCAGGCGT
GAGCATAGTGCGTCGAAGTAGACT -> AGCATAGTGCGTCGAAGTAGACTC
AGGTTTATCGCGCCAAATAGCGGG -> GGTTTATCGCGCCAAATAGCGGGC
AGTTCAGTAACAAGTCGTGCCGTG -> GTTCAGTAACAAGTCGTGCCGTGG
GGCTTCATTAGTCGTTACTTGGTG -> GCTTCATTAGTCGTTACTTGGTGG
TTTGTCGGCATGTCTAAGCTTGCT -> TTGTCGGCATGTCTAAGCTTGCTG
TGATGCGCTCGATTAGTTGAGCAT -> GATGCGCTCGATTAGTTGAGCATA
ATGTTACATCGGTAGAAGACTGTT -> TGTTACATCGGTAGAAGACTGTTT
CGTTGTCATGTCCCGCGTTCCCGC -> GTTGTCATGTCCCGCGTTCCCGCG
TTCATGAATTGACGGCAGGCGTTG -> TCATGAATTGACGGCAGGCGTTGT
CGCATATCCTAGCAGCGACCAGGC -> GCATATCCTAGCAGCGACCAGGCG
TGTCTTCTGGCAAGTAATAGTAGT -> GTCTTCTGGCAAGTAATAGTAGTG
AACTCGGGGAGCCACATGAGAAAC -> ACTCGGGGAGCCACATGAGAAACC
AAAACAGTGCAGCAATATCCCGTC -> AAACAGTGCAGCAATATCCCGTCA
GATAAGTTCGCATCGGGCGCCTAG -> ATAAGTTCGCATCGGGCGCCTAGA
ATTAACTCGTCTTAATACTGAAAG -> TTAACTCGTCTTAATACTGAAAGT
TTGGTGGGAGCACGACTAATCCTC -> TGGTGGGAGCACGACTAATCCTCG
TTTTGCCTGTAAAGCGAAGGGGTG -> TTTGCCTGTAAAGCGAAGGGGTGA
GTGCAGCAATATCCCGTCATAGTT -> TGCAGCAATATCCCGTCATAGTTA
GTTCGGAGCTTAATACCTACTTCA -> TTCGGAGCTTAATACCTACTTCAA
TCTGGTATCATAAAACAGTGCAGC -> CTGGTATCATAAAACAGTGCAGCA
AGTCGTGCCGTGGGCCGCTGATCG -> GTCGTGCCGTGGGCCGCTGATCGT
CGAAGGCTTCATTAGTCGTTACTT -> GAAGGCTTCATTAGTCGTTACTTG
GCATCGGGCGCCTAGAAGCATCCG -> CATCGGGCGCCTAGAAGCATCCGT
AGAATATGCGTCCTTCTGTGCCCC -> GAATATGCGTCCTTCTGTGCCCCG
ACAAGTCGTGCCGTGGGCCGCTGA -> CAAGTCGTGCCGTGGGCCGCTGAT
GGCGCCTAGAAGCATCCGTGACCA -> GCGCCTAGAAGCATCCGTGACCAC
TTGTCGGCATGTCTAAGCTTGCTG -> TGTCGGCATGTCTAAGCTTGCTGG
TAGTGTTTGGCGGGAGGGGTGTAA -> AGTGTTTGGCGGGAGGGGTGTAAG
AGTGCAGGCGGTTGCGGCCCGTAG -> GTGCAGGCGGTTGCGGCCCGTAGC
GTTCTGGGATAAGTTCGCATCGGG -> TTCTGGGATAAGTTCGCATCGGGC
ACGGATACTTGTCGTAACTACGCA -> CGGATACTTGTCGTAACTACGCAC
GGTAGAAGACTGTTTTCCGTCGCT -> GTAGAAGACTGTTTTCCGTCGCTG
TAGGCTTCTAGAATCAAGAATCTG -> AGGCTTCTAGAATCAAGAATCTGA
TCTGATGCGCACTTTCAGTAGACA -> CTGATGCGCACTTTCAGTAGACAT
TTCAGTAACAAGTCGTGCCGTGGG -> TCAGTAACAAGTCGTGCCGTGGGC
CAACCATGACAGCACGGACTTAGC -> AACCATGACAGCACGGACTTAGCC
CGTTATGTCGAAACGATGGCTTGA -> GTTATGTCGAAACGATGGCTTGAA
TCCCGTCATAGTTACGAACGCTCG -> CCCGTCATAGTTACGAACGCTCGC
TAACCCGATGGAACTTGTCCCTTA -> AACCCGATGGAACTTGTCCCTTAT
TCGGCATGTCTAAGCTTGCTGGGC -> CGGCATGTCTAAGCTTGCTGGGCT
TGGAACTTGTCCCTTATGACTCAA -> GGAACTTGTCCCTTATGACTCAAA
CTCGCATGGCGTGCAGGTGTATAG -> TCGCATGGCGTGCAGGTGTATAGC
GAGGCGTCAGCCGAAACTTTATTC -> AGGCGTCAGCCGAAACTTTATTCA
CCGTCATAGTTACGAACGCTCGCA -> CGTCATAGTTACGAACGCTCGCAT
TAGGTACGCCCCGATCGCATATCC -> AGGTACGCCCCGATCGCATATCCT
AAAGATGTCAGTTTTGAACCCTCA -> AAGATGTCAGTTTTGAACCCTCAC
GTCACAAAGGTATGACACCAAAAG -> TCACAAAGGTATGACACCAAAAGA
GCGTTCCCGCGGGATGAGATATTT -> CGTTCCCGCGGGATGAGATATTTC
GCATGGCGTGCAGGTGTATAGCTC -> CATGGCGTGCAGGTGTATAGCTCT
CACTTTCAGTAGACATCCCTACTA -> ACTTTCAGTAGACATCCCTACTAC
AGCATCCGTGACCACAAAGATGTC -> GCATCCGTGACCACAAAGATGTCA
TAGTGCAGGCGGTTGCGGCCCGTA -> AGTGCAGGCGGTTGCGGCCCGTAG
CGCCTAGAAGCATCCGTGACCACA -> GCCTAGAAGCATCCGTGACCACAA
TTGCTTTGGAGGTTTTGCCTGTAA -> TGCTTTGGAGGTTTTGCCTGTAAA
AAAGCGAAGGGGTGATGCGCTCGA -> AAGCGAAGGGGTGATGCGCTCGAT
TCCTAGCAGCGACCAGGCGTCGCG -> CCTAGCAGCGACCAGGCGTCGCGA
CGCACTTTCAGTAGACATCCCTAC -> GCACTTTCAGTAGACATCCCTACT
AAATGACCGGGATTAACTCGTCTT -> AATGACCGGGATTAACTCGTCTTA
CGAACGCTCGCATGGCGTGCAGGT -> GAACGCTCGCATGGCGTGCAGGTG
CGAAGGATAAGCGACGCAACAGCC -> GAAGGATAAGCGACGCAACAGCCG
ACGTTGTGACCGACCTAAAAGAAT -> CGTTGTGACCGACCTAAAAGAATA
CGTGACCACAAAGATGTCAGTTTT -> GTGACCACAAAGATGTCAGTTTTG
ATGGCTCTCAATATTCCCGTTCGG -> TGGCTCTCAATATTCCCGTTCGGT
CGACCGCTACGTGCGGACCTAGTT -> GACCGCTACGTGCGGACCTAGTTC
GCAGTTCGGAGCTTAATACCTACT -> CAGTTCGGAGCTTAATACCTACTT
AGCGACGCAACAGCCGGTCTCCCT -> GCGACGCAACAGCCGGTCTCCCTT
TGTAAGCATGATATACCATAGACT -> GTAAGCATGATATACCATAGACTT
CTTTCATGAATTGACGGCAGGCGT -> TTTCATGAATTGACGGCAGGCGTT
AAGCGAAGGGGTGATGCGCTCGAT -> AGCGAAGGGGTGATGCGCTCGATT
GAAGTTTCCTATCTAATACGCTAT -> AAGTTTCCTATCTAATACGCTATA
CGTTCGGTGGGCTTCGGGTTCTCC -> GTTCGGTGGGCTTCGGGTTCTCCG
ACGTGCGGACCTAGTTCAGTAACA -> CGTGCGGACCTAGTTCAGTAACAA
CGATCAAGTCACAAAGGTATGACA -> GATCAAGTCACAAAGGTATGACAC
TGGCTCTCAATATTCCCGTTCGGT -> GGCTCTCAATATTCCCGTTCGGTG
ACGAACGCTCGCATGGCGTGCAGG -> CGAACGCTCGCATGGCGTGCAGGT
ATGCTGCAGTCCATTTGCTTTGGA -> TGCTGCAGTCCATTTGCTTTGGAG
CTAATACGCTATATAATTTGCAGC -> TAATACGCTATATAATTTGCAGCT
TAGACAGCGCCTGACCATCACCTT -> AGACAGCGCCTGACCATCACCTTC
TACTTGGTGGGAGCACGACTAATC -> ACTTGGTGGGAGCACGACTAATCC
CTGTAAAGCGAAGGGGTGATGCGC -> TGTAAAGCGAAGGGGTGATGCGCT
GTGTAAGCATGATATACCATAGAC -> TGTAAGCATGATATACCATAGACT
ACATCGGTAGAAGACTGTTTTCCG -> CATCGGTAGAAGACTGTTTTCCGT
TTTCATGAATTGACGGCAGGCGTT -> TTCATGAATTGACGGCAGGCGTTG
TGGGAGCACGACTAATCCTCGGAT -> GGGAGCACGACTAATCCTCGGATG
GGGTGTAAGCATGATATACCATAG -> GGTGTAAGCATGATATACCATAGA
CAGCCGGTCTCCCTTTGTCGGCAT -> AGCCGGTCTCCCTTTGTCGGCATG
GAGTGTTAACCCGATGGAACTTGT -> AGTGTTAACCCGATGGAACTTGTC
CTCCACGCAGTTCGGAGCTTAATA -> TCCACGCAGTTCGGAGCTTAATAC
TTCGGGTTCTCCGTCTGACACTGG -> TCGGGTTCTCCGTCTGACACTGGA
GTGGATGCCCGGTCGTCGAGTGAC -> TGGATGCCCGGTCGTCGAGTGACG
GGATACTTGTCGTAACTACGCACC -> GATACTTGTCGTAACTACGCACCC
AGCTTGCTGGGCTCGAAGTATCGC -> GCTTGCTGGGCTCGAAGTATCGCA
AGCCTGCGTATCAGTCCCGACCGC -> GCCTGCGTATCAGTCCCGACCGCT
CCTTTGTCGGCATGTCTAAGCTTG -> CTTTGTCGGCATGTCTAAGCTTGC
GTCGCTGTCTTCTGGCAAGTAATA -> TCGCTGTCTTCTGGCAAGTAATAG
TTCATTAGTCGTTACTTGGTGGGA -> TCATTAGTCGTTACTTGGTGGGAG
CTAAGCTTGCTGGGCTCGAAGTAT -> TAAGCTTGCTGGGCTCGAAGTATC
CCTGTTATAGGCTTCTAGAATCAA -> CTGTTATAGGCTTCTAGAATCAAG
GCAAGTAATAGTAGTGCAGGCGGT -> CAAGTAATAGTAGTGCAGGCGGTT
ATCGGGCGCCTAGAAGCATCCGTG -> TCGGGCGCCTAGAAGCATCCGTGA
TTTGGAGGTTTTGCCTGTAAAGCG -> TTGGAGGTTTTGCCTGTAAAGCGA
GCGCCCCAAGCCAAGGATGATAGC -> CGCCCCAAGCCAAGGATGATAGCA
GCTCTCAATATTCCCGTTCGGTGG -> CTCTCAATATTCCCGTTCGGTGGG
TCGAAGTAGACTCCTCCAAAGCCT -> CGAAGTAGACTCCTCCAAAGCCTC
GACGGCAGGCGTTGTCATGTCCCG -> ACGGCAGGCGTTGTCATGTCCCGC
AATATGCGTCCTTCTGTGCCCCGG -> ATATGCGTCCTTCTGTGCCCCGGC
GTGGGCCGCTGATCGTGTTAGAGA -> TGGGCCGCTGATCGTGTTAGAGAA
GTTCTCCGTCTGACACTGGAACGT -> TTCTCCGTCTGACACTGGAACGTC
TCAGTCCCGACCGCTACGTGCGGA -> CAGTCCCGACCGCTACGTGCGGAC
CCTGCGTATCAGTCCCGACCGCTA -> CTGCGTATCAGTCCCGACCGCTAC
CAACACCTGTTATAGGCTTCTAGA -> AACACCTGTTATAGGCTTCTAGAA
CACAATACCGAGTGTTAACCCGAT -> ACAATACCGAGTGTTAACCCGATG
CCCGATCGCATATCCTAGCAGCGA -> CCGATCGCATATCCTAGCAGCGAC
ACCGGTGCACAGTGTTGAGTGGGG -> CCGGTGCACAGTGTTGAGTGGGGA
AGCACGACTAATCCTCGGATGGCT -> GCACGACTAATCCTCGGATGGCTC
TAGACATCCCTACTACCAACGACA -> AGACATCCCTACTACCAACGACAA
GCGCACTTTCAGTAGACATCCCTA -> CGCACTTTCAGTAGACATCCCTAC
CACTCTGGAGCACAATACCGAGTG -> ACTCTGGAGCACAATACCGAGTGT
ATGGGCCGTTAACCTCTCGTCTGA -> TGGGCCGTTAACCTCTCGTCTGAT
CTCTCAATATTCCCGTTCGGTGGG -> TCTCAATATTCCCGTTCGGTGGGC
AGTGTTGAGTGGGGACGAAAATGG -> GTGTTGAGTGGGGACGAAAATGGC
AACTCGTCTTAATACTGAAAGTGT -> ACTCGTCTTAATACTGAAAGTGTC
CCCCGGCCCTCGCTTAATTGCACG -> CCCGGCCCTCGCTTAATTGCACGA
GGGAGCACGACTAATCCTCGGATG -> GGAGCACGACTAATCCTCGGATGG
TTATAATGCGATCACGGATACTTG -> TATAATGCGATCACGGATACTTGT
AATTGGGCGCCCCAAGCCAAGGAT -> ATTGGGCGCCCCAAGCCAAGGATG
CACAGTGTTGAGTGGGGACGAAAA -> ACAGTGTTGAGTGGGGACGAAAAT
CAAAGATGTCAGTTTTGAACCCTC -> AAAGATGTCAGTTTTGAACCCTCA
ATGGCACTGCCCTAGATTTCAACC -> TGGCACTGCCCTAGATTTCAACCA
GAATGGGCCGTTAACCTCTCGTCT -> AATGGGCCGTTAACCTCTCGTCTG
TTAATACCTACTTCAAAACGACTT -> TAATACCTACTTCAAAACGACTTA
CTTGAACCTCTGCTTAGATGTTAC -> TTGAACCTCTGCTTAGATGTTACA
TCTGACACTGGAACGTCCGGTGAC -> CTGACACTGGAACGTCCGGTGACT
TTGTGACCGACCTAAAAGAATATG -> TGTGACCGACCTAAAAGAATATGC
AGGAATGGGCCGTTAACCTCTCGT -> GGAATGGGCCGTTAACCTCTCGTC
CTGAGACGTTGTGACCGACCTAAA -> TGAGACGTTGTGACCGACCTAAAA
AGGACGGAAGTTTCCTATCTAATA -> GGACGGAAGTTTCCTATCTAATAC
CTCGGATGGCTCTCAATATTCCCG -> TCGGATGGCTCTCAATATTCCCGT
TAATACTGAAAGTGTCTGGTATCA -> AATACTGAAAGTGTCTGGTATCAT
GGATGCCCGGTCGTCGAGTGACGT -> GATGCCCGGTCGTCGAGTGACGTA
GGCGTCAGCCGAAACTTTATTCAG -> GCGTCAGCCGAAACTTTATTCAGT
GAACCCTCACACCGGTGCACAGTG -> AACCCTCACACCGGTGCACAGTGT
ATGGAACTTGTCCCTTATGACTCA -> TGGAACTTGTCCCTTATGACTCAA
TTTGCAGCTTATAATGCGATCACG -> TTGCAGCTTATAATGCGATCACGG
GTAACTACGCACCCCCAACAAACA -> TAACTACGCACCCCCAACAAACAG
TGAGATATTTCGGATTTGTGCCAA -> GAGATATTTCGGATTTGTGCCAAA
TGTCTGGTATCATAAAACAGTGCA -> GTCTGGTATCATAAAACAGTGCAG
AGAAACCTAGTATCGCAGGAGGTT -> GAAACCTAGTATCGCAGGAGGTTT
CGTTCCCGCGGGATGAGATATTTC -> GTTCCCGCGGGATGAGATATTTCG
GATGATAGCAACACCTGTTATAGG -> ATGATAGCAACACCTGTTATAGGC
TGGGCCGTTAACCTCTCGTCTGAT -> GGGCCGTTAACCTCTCGTCTGATG
GTTTGGGGCAGACACGATCAAGTC -> TTTGGGGCAGACACGATCAAGTCA
GAGATATTTCGGATTTGTGCCAAA -> AGATATTTCGGATTTGTGCCAAAT
CGATGGAACTTGTCCCTTATGACT -> GATGGAACTTGTCCCTTATGACTC
TCAACCATGACAGCACGGACTTAG -> CAACCATGACAGCACGGACTTAGC
CTTGTCCCTTATGACTCAAACAGC -> TTGTCCCTTATGACTCAAACAGCG
ACAAACAGCCAACTCCCATGTGCG -> CAAACAGCCAACTCCCATGTGCGG
CCATCACCTTCACCATCCTCGAGT -> CATCACCTTCACCATCCTCGAGTC
TCGCATCGGGCGCCTAGAAGCATC -> CGCATCGGGCGCCTAGAAGCATCC
GCTGAATAAACAGTCTTAACTTAT -> CTGAATAAACAGTCTTAACTTATC
AACAGCCAACTCCCATGTGCGGTT -> ACAGCCAACTCCCATGTGCGGTTC
TTAACCTCTCGTCTGATGCGCACT -> TAACCTCTCGTCTGATGCGCACTT
TACGCACCCCCAACAAACAGCCAA -> ACGCACCCCCAACAAACAGCCAAC
TGAACCCTCACACCGGTGCACAGT -> GAACCCTCACACCGGTGCACAGTG
GTGATGCGCTCGATTAGTTGAGCA -> TGATGCGCTCGATTAGTTGAGCAT
TTCCGTCGCTGTCTTCTGGCAAGT -> TCCGTCGCTGTCTTCTGGCAAGTA
TCAGTAACAAGTCGTGCCGTGGGC -> CAGTAACAAGTCGTGCCGTGGGCC
ACATCCCTACTACCAACGACAACT -> CATCCCTACTACCAACGACAACTC
AGTTGAGTTCTGGGATAAGTTCGC -> GTTGAGTTCTGGGATAAGTTCGCA
CATAGGTACGCCCCGATCGCATAT -> ATAGGTACGCCCCGATCGCATATC
CGCCTGCCTCTCCAGGAGTTCGTT -> GCCTGCCTCTCCAGGAGTTCGTTA
AGTAGACTCCTCCAAAGCCTCCAC -> GTAGACTCCTCCAAAGCCTCCACG
GCGTTGTCATGTCCCGCGTTCCCG -> CGTTGTCATGTCCCGCGTTCCCGC
CAGTAACAAGTCGTGCCGTGGGCC -> AGTAACAAGTCGTGCCGTGGGCCG
ACCAGGCGTCGCGACTCGTAAACG -> CCAGGCGTCGCGACTCGTAAACGA
CATGACAGCACGGACTTAGCCTGC -> ATGACAGCACGGACTTAGCCTGCG
AAAGAAAGCTACGCTGAATAAACA -> AAGAAAGCTACGCTGAATAAACAG
CGTCAGCCGAAACTTTATTCAGTT -> GTCAGCCGAAACTTTATTCAGTTA
CTGTTTTCCGTCGCTGTCTTCTGG -> TGTTTTCCGTCGCTGTCTTCTGGC
TTCCTATCTAATACGCTATATAAT -> TCCTATCTAATACGCTATATAATT
GTCTAAGCTTGCTGGGCTCGAAGT -> TCTAAGCTTGCTGGGCTCGAAGTA
TCCGTGACCACAAAGATGTCAGTT -> CCGTGACCACAAAGATGTCAGTTT
TGTCAGTTTTGAACCCTCACACCG -> GTCAGTTTTGAACCCTCACACCGG
CATAGACTTAGGACGGAAGTTTCC -> ATAGACTTAGGACGGAAGTTTCCT
CGGTGACTGTTATGCCTCTTGCGT -> GGTGACTGTTATGCCTCTTGCGTC
GGGCAGACACGATCAAGTCACAAA -> GGCAGACACGATCAAGTCACAAAG
ACTGGAACGTCCGGTGACTGTTAT -> CTGGAACGTCCGGTGACTGTTATG
ACACACGGCGATGAGGCGTCAGCC -> CACACGGCGATGAGGCGTCAGCCG
TCGTTATGTCGAAACGATGGCTTG -> CGTTATGTCGAAACGATGGCTTGA
GGTCTCCCTTTGTCGGCATGTCTA -> GTCTCCCTTTGTCGGCATGTCTAA
TGCGCACTTTCAGTAGACATCCCT -> GCGCACTTTCAGTAGACATCCCTA
GACTTAGGACGGAAGTTTCCTATC -> ACTTAGGACGGAAGTTTCCTATCT
TATTCAGTTAACACGAAATGACCG -> ATTCAGTTAACACGAAATGACCGG
TGGGGCAGACACGATCAAGTCACA -> GGGGCAGACACGATCAAGTCACAA
CCTAGAAGCATCCGTGACCACAAA -> CTAGAAGCATCCGTGACCACAAAG
GGTGATGCGCTCGATTAGTTGAGC -> GTGATGCGCTCGATTAGTTGAGCA
GTGTTTGGCGGGAGGGGTGTAAGC -> TGTTTGGCGGGAGGGGTGTAAGCA
AGCTTAATACCTACTTCAAAACGA -> GCTTAATACCTACTTCAAAACGAC
CAAAAGAAGTTGAGTTCTGGGATA -> AAAAGAAGTTGAGTTCTGGGATAA
TCGGATGGCTCTCAATATTCCCGT -> CGGATGGCTCTCAATATTCCCGTT
CGTTATGGATTCGTTATGTCGAAA -> GTTATGGATTCGTTATGTCGAAAC
CGATCGCATATCCTAGCAGCGACC -> GATCGCATATCCTAGCAGCGACCA
ACGCAGTTCGGAGCTTAATACCTA -> CGCAGTTCGGAGCTTAATACCTAC
GAGACGTTGTGACCGACCTAAAAG -> AGACGTTGTGACCGACCTAAAAGA
TGTGCCAAATGCTGCAGTCCATTT -> GTGCCAAATGCTGCAGTCCATTTG
CCCTCCATAGGTACGCCCCGATCG -> CCTCCATAGGTACGCCCCGATCGC
CGACAACTCGGGGAGCCACATGAG -> GACAACTCGGGGAGCCACATGAGA
GTTCCCGCGGGATGAGATATTTCG -> TTCCCGCGGGATGAGATATTTCGG
GCGAAGGATAAGCGACGCAACAGC -> CGAAGGATAAGCGACGCAACAGCC
GCAGTTTGGGGCAGACACGATCAA -> CAGTTTGGGGCAGACACGATCAAG
TTCAGTAGACATCCCTACTACCAA -> TCAGTAGACATCCCTACTACCAAC
CAGTTAACACGAAATGACCGGGAT -> AGTTAACACGAAATGACCGGGATT
CTCTGGAGCACAATACCGAGTGTT -> TCTGGAGCACAATACCGAGTGTTA
AATATTCCCGTTCGGTGGGCTTCG -> ATATTCCCGTTCGGTGGGCTTCGG
TATATAATTTGCAGCTTATAATGC -> ATATAATTTGCAGCTTATAATGCG
CGCAACAGCCGGTCTCCCTTTGTC -> GCAACAGCCGGTCTCCCTTTGTCG
CGTCCTTCTGTGCCCCGGCCCTCG -> GTCCTTCTGTGCCCCGGCCCTCGC
ATGCGATCACGGATACTTGTCGTA -> TGCGATCACGGATACTTGTCGTAA
CCGGTCTCCCTTTGTCGGCATGTC -> CGGTCTCCCTTTGTCGGCATGTCT
CGGCCCTCGCTTAATTGCACGAAG -> GGCCCTCGCTTAATTGCACGAAGC
AGAAGTTGAGTTCTGGGATAAGTT -> GAAGTTGAGTTCTGGGATAAGTTC
ATAGCTCTGTTAGTCGACGCCTGC -> TAGCTCTGTTAGTCGACGCCTGCC
TGCGTCGAAGTAGACTCCTCCAAA -> GCGTCGAAGTAGACTCCTCCAAAG
GGACGGAAGTTTCCTATCTAATAC -> GACGGAAGTTTCCTATCTAATACG
ACACGTGGATGCCCGGTCGTCGAG -> CACGTGGATGCCCGGTCGTCGAGT
CAGTTCGGAGCTTAATACCTACTT -> AGTTCGGAGCTTAATACCTACTTC
CATAGTTACGAACGCTCGCATGGC -> ATAGTTACGAACGCTCGCATGGCG
TTGTCGTAACTACGCACCCCCAAC -> TGTCGTAACTACGCACCCCCAACA
GTAGACTCCTCCAAAGCCTCCACG -> TAGACTCCTCCAAAGCCTCCACGC
TATTCCCGTTCGGTGGGCTTCGGG -> ATTCCCGTTCGGTGGGCTTCGGGT
GACGCAACAGCCGGTCTCCCTTTG -> ACGCAACAGCCGGTCTCCCTTTGT
GATGCGCTCGATTAGTTGAGCATA -> ATGCGCTCGATTAGTTGAGCATAG
AAGGTATGACACCAAAAGAAGTTG -> AGGTATGACACCAAAAGAAGTTGA
AGCGGGCACCACACGTGGATGCCC -> GCGGGCACCACACGTGGATGCCCG
GATCGCATATCCTAGCAGCGACCA -> ATCGCATATCCTAGCAGCGACCAG
GTTCGCATCGGGCGCCTAGAAGCA -> TTCGCATCGGGCGCCTAGAAGCAT
GTCTTTCATGAATTGACGGCAGGC -> TCTTTCATGAATTGACGGCAGGCG
GGAGCACAATACCGAGTGTTAACC -> GAGCACAATACCGAGTGTTAACCC
CAGCCGAAACTTTATTCAGTTAAC -> AGCCGAAACTTTATTCAGTTAACA
GTATCGCAGGAGGTTTATCGCGCC -> TATCGCAGGAGGTTTATCGCGCCA
ATGCGCACTTTCAGTAGACATCCC -> TGCGCACTTTCAGTAGACATCCCT
AATTGACGGCAGGCGTTGTCATGT -> ATTGACGGCAGGCGTTGTCATGTC
CGTAAACGAAGGCTTCATTAGTCG -> GTAAACGAAGGCTTCATTAGTCGT
AAAGAAGTTGAGTTCTGGGATAAG -> AAGAAGTTGAGTTCTGGGATAAGT
CCCCGATCGCATATCCTAGCAGCG -> CCCGATCGCATATCCTAGCAGCGA
AATCTGAGACGTTGTGACCGACCT -> ATCTGAGACGTTGTGACCGACCTA
GCGACCAGGCGTCGCGACTCGTAA -> CGACCAGGCGTCGCGACTCGTAAA
ACGACTAATCCTCGGATGGCTCTC -> CGACTAATCCTCGGATGGCTCTCA
TGGAGCACAATACCGAGTGTTAAC -> GGAGCACAATACCGAGTGTTAACC
TTCTCCGTCTGACACTGGAACGTC -> TCTCCGTCTGACACTGGAACGTCC
GATCGTGTTAGAGAAAACACACGG -> ATCGTGTTAGAGAAAACACACGGC
ATCCTCGGATGGCTCTCAATATTC -> TCCTCGGATGGCTCTCAATATTCC
TCAACTAGACAGCGCCTGACCATC -> CAACTAGACAGCGCCTGACCATCA
ACCTTCACCATCCTCGAGTCCGTG -> CCTTCACCATCCTCGAGTCCGTGA
GAGTCCGTGATGCCTGGTAAGCAG -> AGTCCGTGATGCCTGGTAAGCAGT
CCTCGAGTCCGTGATGCCTGGTAA -> CTCGAGTCCGTGATGCCTGGTAAG
CGAAATGACCGGGATTAACTCGTC -> GAAATGACCGGGATTAACTCGTCT
CACACGTGGATGCCCGGTCGTCGA -> ACACGTGGATGCCCGGTCGTCGAG
AAGCCAAGGATGATAGCAACACCT -> AGCCAAGGATGATAGCAACACCTG
CCGTGGGCCGCTGATCGTGTTAGA -> CGTGGGCCGCTGATCGTGTTAGAG
AAGATGTCAGTTTTGAACCCTCAC -> AGATGTCAGTTTTGAACCCTCACA
GAAGGGGTGATGCGCTCGATTAGT -> AAGGGGTGATGCGCTCGATTAGTT
TCTCGTCTGATGCGCACTTTCAGT -> CTCGTCTGATGCGCACTTTCAGTA
GCACTCTGGAGCACAATACCGAGT -> CACTCTGGAGCACAATACCGAGTG
TTCACCATCCTCGAGTCCGTGATG -> TCACCATCCTCGAGTCCGTGATGC
AGTTCGGAGCTTAATACCTACTTC -> GTTCGGAGCTTAATACCTACTTCA
CCAAATAGCGGGCACCACACGTGG -> CAAATAGCGGGCACCACACGTGGA
GCAATATCCCGTCATAGTTACGAA -> CAATATCCCGTCATAGTTACGAAC
GACCGGGATTAACTCGTCTTAATA -> ACCGGGATTAACTCGTCTTAATAC
TGATAGCAACACCTGTTATAGGCT -> GATAGCAACACCTGTTATAGGCTT
AAGGATAAGCGACGCAACAGCCGG -> AGGATAAGCGACGCAACAGCCGGT
CGCTGTCTTCTGGCAAGTAATAGT -> GCTGTCTTCTGGCAAGTAATAGTA
CAGCTTATAATGCGATCACGGATA -> AGCTTATAATGCGATCACGGATAC
GAAGGATAAGCGACGCAACAGCCG -> AAGGATAAGCGACGCAACAGCCGG
CTTAGATGTTACATCGGTAGAAGA -> TTAGATGTTACATCGGTAGAAGAC
CGGGAGGGGTGTAAGCATGATATA -> GGGAGGGGTGTAAGCATGATATAC
AAGCATCCGTGACCACAAAGATGT -> AGCATCCGTGACCACAAAGATGTC
TGTGCCCCGGCCCTCGCTTAATTG -> GTGCCCCGGCCCTCGCTTAATTGC
GGCCCTCGCTTAATTGCACGAAGC -> GCCCTCGCTTAATTGCACGAAGCA
GGTTTATCGCGCCAAATAGCGGGC -> GTTTATCGCGCCAAATAGCGGGCA
AACAAACAGCCAACTCCCATGTGC -> ACAAACAGCCAACTCCCATGTGCG
GCGTCCTTCTGTGCCCCGGCCCTC -> CGTCCTTCTGTGCCCCGGCCCTCG
TCTTCTGGCAAGTAATAGTAGTGC -> CTTCTGGCAAGTAATAGTAGTGCA
GAACTTGTCCCTTATGACTCAAAC -> AACTTGTCCCTTATGACTCAAACA
CTACGCTGAATAAACAGTCTTAAC -> TACGCTGAATAAACAGTCTTAACT
GCGAAGGGGTGATGCGCTCGATTA -> CGAAGGGGTGATGCGCTCGATTAG
AATCAAGAATCTGAGACGTTGTGA -> ATCAAGAATCTGAGACGTTGTGAC
ACGGACTTAGCCTGCGTATCAGTC -> CGGACTTAGCCTGCGTATCAGTCC
CTAGAAGCATCCGTGACCACAAAG -> TAGAAGCATCCGTGACCACAAAGA
GTTCCCTCCATAGGTACGCCCCGA -> TTCCCTCCATAGGTACGCCCCGAT
ATCGGTAGAAGACTGTTTTCCGTC -> TCGGTAGAAGACTGTTTTCCGTCG
GAAAACACACGGCGATGAGGCGTC -> AAAACACACGGCGATGAGGCGTCA
GCAACAGCCGGTCTCCCTTTGTCG -> CAACAGCCGGTCTCCCTTTGTCGG
TAGACTTAGGACGGAAGTTTCCTA -> AGACTTAGGACGGAAGTTTCCTAT
CGAAGTAGACTCCTCCAAAGCCTC -> GAAGTAGACTCCTCCAAAGCCTCC
CCAAAAGAAGTTGAGTTCTGGGAT -> CAAAAGAAGTTGAGTTCTGGGATA
AGCCACATGAGAAACCTAGTATCG -> GCCACATGAGAAACCTAGTATCGC
ACCGACCTAAAAGAATATGCGTCC -> CCGACCTAAAAGAATATGCGTCCT
TGAGTGGGGACGAAAATGGCACTG -> GAGTGGGGACGAAAATGGCACTGC
CGGAAGTTTCCTATCTAATACGCT -> GGAAGTTTCCTATCTAATACGCTA
TTGAACCCTCACACCGGTGCACAG -> TGAACCCTCACACCGGTGCACAGT
ACCACAAAGATGTCAGTTTTGAAC -> CCACAAAGATGTCAGTTTTGAACC
TAGATGTTACATCGGTAGAAGACT -> AGATGTTACATCGGTAGAAGACTG
ACGCCTGCCTCTCCAGGAGTTCGT -> CGCCTGCCTCTCCAGGAGTTCGTT
AATACGCTATATAATTTGCAGCTT -> ATACGCTATATAATTTGCAGCTTA
TTACATCGGTAGAAGACTGTTTTC -> TACATCGGTAGAAGACTGTTTTCC
AATGACCGGGATTAACTCGTCTTA -> ATGACCGGGATTAACTCGTCTTAA
CCCGCGGGATGAGATATTTCGGAT -> CCGCGGGATGAGATATTTCGGATT
GGCATGTCTAAGCTTGCTGGGCTC -> GCATGTCTAAGCTTGCTGGGCTCG
CACACGGCGATGAGGCGTCAGCCG -> ACACGGCGATGAGGCGTCAGCCGA
AGTTCGTTATGGATTCGTTATGTC -> GTTCGTTATGGATTCGTTATGTCG
GAGCTTAATACCTACTTCAAAACG -> AGCTTAATACCTACTTCAAAACGA
GAAGTAGACTCCTCCAAAGCCTCC -> AAGTAGACTCCTCCAAAGCCTCCA
GAGGGGTGTAAGCATGATATACCA -> AGGGGTGTAAGCATGATATACCAT
GTGATGCCTGGTAAGCAGTTTGGG -> TGATGCCTGGTAAGCAGTTTGGGG
GCCCTCGCTTAATTGCACGAAGCA -> CCCTCGCTTAATTGCACGAAGCAG
CCTGGTAAGCAGTTTGGGGCAGAC -> CTGGTAAGCAGTTTGGGGCAGACA
ATAGGCTTCTAGAATCAAGAATCT -> TAGGCTTCTAGAATCAAGAATCTG
ATTTGCAGCTTATAATGCGATCAC -> TTTGCAGCTTATAATGCGATCACG
GATAGCAACACCTGTTATAGGCTT -> ATAGCAACACCTGTTATAGGCTTC
TGTCCCGCGTTCCCGCGGGATGAG -> GTCCCGCGTTCCCGCGGGATGAGA
TCTTAATACTGAAAGTGTCTGGTA -> CTTAATACTGAAAGTGTCTGGTAT
TCTCCAGGAGTTCGTTATGGATTC -> CTCCAGGAGTTCGTTATGGATTCG
GCCGCTGATCGTGTTAGAGAAAAC -> CCGCTGATCGTGTTAGAGAAAACA
AGTCACAAAGGTATGACACCAAAA -> GTCACAAAGGTATGACACCAAAAG
TTATCGCGCCAAATAGCGGGCACC -> TATCGCGCCAAATAGCGGGCACCA
GTGGGGACGAAAATGGCACTGCCC -> TGGGGACGAAAATGGCACTGCCCT
CGTTACTTGGTGGGAGCACGACTA -> GTTACTTGGTGGGAGCACGACTAA
TACTACCAACGACAACTCGGGGAG -> ACTACCAACGACAACTCGGGGAGC
TACCTACTTCAAAACGACTTAGAG -> ACCTACTTCAAAACGACTTAGAGG
TTCTAGAATCAAGAATCTGAGACG -> TCTAGAATCAAGAATCTGAGACGT
AGGATAAGCGACGCAACAGCCGGT -> GGATAAGCGACGCAACAGCCGGTC
AGTGCGTCGAAGTAGACTCCTCCA -> GTGCGTCGAAGTAGACTCCTCCAA
CCAAATGCTGCAGTCCATTTGCTT -> CAAATGCTGCAGTCCATTTGCTTT
GACCTAGTTCAGTAACAAGTCGTG -> ACCTAGTTCAGTAACAAGTCGTGC
CTCGTCTTAATACTGAAAGTGTCT -> TCGTCTTAATACTGAAAGTGTCTG
TCCCTTATGACTCAAACAGCGAAG -> CCCTTATGACTCAAACAGCGAAGG
CGGGCGCCTAGAAGCATCCGTGAC -> GGGCGCCTAGAAGCATCCGTGACC
ACGGCAGGCGTTGTCATGTCCCGC -> CGGCAGGCGTTGTCATGTCCCGCG
TAACAAGTCGTGCCGTGGGCCGCT -> AACAAGTCGTGCCGTGGGCCGCTG
GTCTGGTATCATAAAACAGTGCAG -> TCTGGTATCATAAAACAGTGCAGC
AGATGTCAGTTTTGAACCCTCACA -> GATGTCAGTTTTGAACCCTCACAC
GTTGTCATGTCCCGCGTTCCCGCG -> TTGTCATGTCCCGCGTTCCCGCGG
GTCCATTTGCTTTGGAGGTTTTGC -> TCCATTTGCTTTGGAGGTTTTGCC
ATTCCCGTTCGGTGGGCTTCGGGT -> TTCCCGTTCGGTGGGCTTCGGGTT
GGAGCCACATGAGAAACCTAGTAT -> GAGCCACATGAGAAACCTAGTATC
ACTTCAAAACGACTTAGAGGAATG -> CTTCAAAACGACTTAGAGGAATGG
AGTATCGCAGGAGGTTTATCGCGC -> GTATCGCAGGAGGTTTATCGCGCC
GACGGAAGTTTCCTATCTAATACG -> ACGGAAGTTTCCTATCTAATACGC
TCGCATATCCTAGCAGCGACCAGG -> CGCATATCCTAGCAGCGACCAGGC
CAGCAATATCCCGTCATAGTTACG -> AGCAATATCCCGTCATAGTTACGA
GGACTTAGCCTGCGTATCAGTCCC -> GACTTAGCCTGCGTATCAGTCCCG
CCACAAAGATGTCAGTTTTGAACC -> CACAAAGATGTCAGTTTTGAACCC
TCCTCGAGTCCGTGATGCCTGGTA -> CCTCGAGTCCGTGATGCCTGGTAA
TGACCGGGATTAACTCGTCTTAAT -> GACCGGGATTAACTCGTCTTAATA
TAGCAACACCTGTTATAGGCTTCT -> AGCAACACCTGTTATAGGCTTCTA
AATACTGAAAGTGTCTGGTATCAT -> ATACTGAAAGTGTCTGGTATCATA
CAGGCGTTGTCATGTCCCGCGTTC -> AGGCGTTGTCATGTCCCGCGTTCC
TGGATGCCCGGTCGTCGAGTGACG -> GGATGCCCGGTCGTCGAGTGACGT
TCGGGGAGCCACATGAGAAACCTA -> CGGGGAGCCACATGAGAAACCTAG
GTACGCCCCGATCGCATATCCTAG -> TACGCCCCGATCGCATATCCTAGC
ACTTAGCCTGCGTATCAGTCCCGA -> CTTAGCCTGCGTATCAGTCCCGAC
GCTGCAGTCCATTTGCTTTGGAGG -> CTGCAGTCCATTTGCTTTGGAGGT
CTCGAAGTATCGCACTAGTGTTTG -> TCGAAGTATCGCACTAGTGTTTGG
CAGCACGGACTTAGCCTGCGTATC -> AGCACGGACTTAGCCTGCGTATCA
CTCGAGTCCGTGATGCCTGGTAAG -> TCGAGTCCGTGATGCCTGGTAAGC
GCGTATCAGTCCCGACCGCTACGT -> CGTATCAGTCCCGACCGCTACGTG
TCGGAGCTTAATACCTACTTCAAA -> CGGAGCTTAATACCTACTTCAAAA
GACTGTTTTCCGTCGCTGTCTTCT -> ACTGTTTTCCGTCGCTGTCTTCTG
AAACGACTTAGAGGAATGGGCCGT -> AACGACTTAGAGGAATGGGCCGTT
GATAAGCGACGCAACAGCCGGTCT -> ATAAGCGACGCAACAGCCGGTCTC
CTCCCATGTGCGGTTCCCTCCATA -> TCCCATGTGCGGTTCCCTCCATAG
AGTGGGGACGAAAATGGCACTGCC -> GTGGGGACGAAAATGGCACTGCCC
AGCCTCCACGCAGTTCGGAGCTTA -> GCCTCCACGCAGTTCGGAGCTTAA
TATCGCACTAGTGTTTGGCGGGAG -> ATCGCACTAGTGTTTGGCGGGAGG
ATGACACCAAAAGAAGTTGAGTTC -> TGACACCAAAAGAAGTTGAGTTCT
CGTGCGGACCTAGTTCAGTAACAA -> GTGCGGACCTAGTTCAGTAACAAG
TTACGAACGCTCGCATGGCGTGCA -> TACGAACGCTCGCATGGCGTGCAG
CAGGAGTTCGTTATGGATTCGTTA -> AGGAGTTCGTTATGGATTCGTTAT
CAACGACAACTCGGGGAGCCACAT -> AACGACAACTCGGGGAGCCACATG
GAGCACGACTAATCCTCGGATGGC -> AGCACGACTAATCCTCGGATGGCT
GGTGGGCTTCGGGTTCTCCGTCTG -> GTGGGCTTCGGGTTCTCCGTCTGA
TCGAGTGACGTACTCAACTAGACA -> CGAGTGACGTACTCAACTAGACAG
TGTTTTCCGTCGCTGTCTTCTGGC -> GTTTTCCGTCGCTGTCTTCTGGCA
AAAATGGCACTGCCCTAGATTTCA -> AAATGGCACTGCCCTAGATTTCAA
GACACCAAAAGAAGTTGAGTTCTG -> ACACCAAAAGAAGTTGAGTTCTGG
TGGGCTCGAAGTATCGCACTAGTG -> GGGCTCGAAGTATCGCACTAGTGT
CTCCTCCAAAGCCTCCACGCAGTT -> TCCTCCAAAGCCTCCACGCAGTTC
ATATACCATAGACTTAGGACGGAA -> TATACCATAGACTTAGGACGGAAG
ACGGAAGTTTCCTATCTAATACGC -> CGGAAGTTTCCTATCTAATACGCT
CAGGCGGTTGCGGCCCGTAGCCTG -> AGGCGGTTGCGGCCCGTAGCCTGA
ACTTGTCCCTTATGACTCAAACAG -> CTTGTCCCTTATGACTCAAACAGC
GGCGTGCAGGTGTATAGCTCTGTT -> GCGTGCAGGTGTATAGCTCTGTTA
GTTGTGACCGACCTAAAAGAATAT -> TTGTGACCGACCTAAAAGAATATG
GCACAATACCGAGTGTTAACCCGA -> CACAATACCGAGTGTTAACCCGAT
GCAGCGACCAGGCGTCGCGACTCG -> CAGCGACCAGGCGTCGCGACTCGT
GTAAGCAGTTTGGGGCAGACACGA -> TAAGCAGTTTGGGGCAGACACGAT
GCTGTCTTCTGGCAAGTAATAGTA -> CTGTCTTCTGGCAAGTAATAGTAG
CCGTCTGACACTGGAACGTCCGGT -> CGTCTGACACTGGAACGTCCGGTG
AGAAGCATCCGTGACCACAAAGAT -> GAAGCATCCGTGACCACAAAGATG
TTATTCAGTTAACACGAAATGACC -> TATTCAGTTAACACGAAATGACCG
GCAGACATAATGCACTCTGGAGCA -> CAGACATAATGCACTCTGGAGCAC
CTTCTGTGCCCCGGCCCTCGCTTA -> TTCTGTGCCCCGGCCCTCGCTTAA
GCGTCAGCCGAAACTTTATTCAGT -> CGTCAGCCGAAACTTTATTCAGTT
CGTCGAAGTAGACTCCTCCAAAGC -> GTCGAAGTAGACTCCTCCAAAGCC
GCCGTTAACCTCTCGTCTGATGCG -> CCGTTAACCTCTCGTCTGATGCGC
GCATCCGTGACCACAAAGATGTCA -> CATCCGTGACCACAAAGATGTCAG
AAGTCACAAAGGTATGACACCAAA -> AGTCACAAAGGTATGACACCAAAA
CGACTTAGAGGAATGGGCCGTTAA -> GACTTAGAGGAATGGGCCGTTAAC
TCACAAAGGTATGACACCAAAAGA -> CACAAAGGTATGACACCAAAAGAA
TCCGGTGACTGTTATGCCTCTTGC -> CCGGTGACTGTTATGCCTCTTGCG
TCAAGAATCTGAGACGTTGTGACC -> CAAGAATCTGAGACGTTGTGACCG
TATCGCAGGAGGTTTATCGCGCCA -> ATCGCAGGAGGTTTATCGCGCCAA
TTATGGATTCGTTATGTCGAAACG -> TATGGATTCGTTATGTCGAAACGA
CCTAAAAGAATATGCGTCCTTCTG -> CTAAAAGAATATGCGTCCTTCTGT
ACGATCAAGTCACAAAGGTATGAC -> CGATCAAGTCACAAAGGTATGACA
TCGGGCGCCTAGAAGCATCCGTGA -> CGGGCGCCTAGAAGCATCCGTGAC
TCGTAACTACGCACCCCCAACAAA -> CGTAACTACGCACCCCCAACAAAC
CCTAGTTCAGTAACAAGTCGTGCC -> CTAGTTCAGTAACAAGTCGTGCCG
CCTTATGACTCAAACAGCGAAGGA -> CTTATGACTCAAACAGCGAAGGAT
GGGGTGATGCGCTCGATTAGTTGA -> GGGTGATGCGCTCGATTAGTTGAG
CTCACACCGGTGCACAGTGTTGAG -> TCACACCGGTGCACAGTGTTGAGT
CTCGGGGAGCCACATGAGAAACCT -> TCGGGGAGCCACATGAGAAACCTA
TGTCGTAACTACGCACCCCCAACA -> GTCGTAACTACGCACCCCCAACAA
ACTACGCACCCCCAACAAACAGCC -> CTACGCACCCCCAACAAACAGCCA
CGTGCAGGTGTATAGCTCTGTTAG -> GTGCAGGTGTATAGCTCTGTTAGT
CCACACGTGGATGCCCGGTCGTCG -> CACACGTGGATGCCCGGTCGTCGA
GTGCGGACCTAGTTCAGTAACAAG -> TGCGGACCTAGTTCAGTAACAAGT
ATAGTTACGAACGCTCGCATGGCG -> TAGTTACGAACGCTCGCATGGCGT
GGTAAGCAGTTTGGGGCAGACACG -> GTAAGCAGTTTGGGGCAGACACGA
CTTGGTGGGAGCACGACTAATCCT -> TTGGTGGGAGCACGACTAATCCTC
CGAAACGATGGCTTGAACCTCTGC -> GAAACGATGGCTTGAACCTCTGCT
ATTAGTTGAGCATAGTGCGTCGAA -> TTAGTTGAGCATAGTGCGTCGAAG
TGTTACATCGGTAGAAGACTGTTT -> GTTACATCGGTAGAAGACTGTTTT
CAGTAGACATCCCTACTACCAACG -> AGTAGACATCCCTACTACCAACGA
TCGGGTTCTCCGTCTGACACTGGA -> CGGGTTCTCCGTCTGACACTGGAA
TGCGTCTTTCATGAATTGACGGCA -> GCGTCTTTCATGAATTGACGGCAG
CGCTGATCGTGTTAGAGAAAACAC -> GCTGATCGTGTTAGAGAAAACACA
CCGCGGGATGAGATATTTCGGATT -> CGCGGGATGAGATATTTCGGATTT
TAAAGCGAAGGGGTGATGCGCTCG -> AAAGCGAAGGGGTGATGCGCTCGA
GAAAGTGTCTGGTATCATAAAACA -> AAAGTGTCTGGTATCATAAAACAG
TAGTTACGAACGCTCGCATGGCGT -> AGTTACGAACGCTCGCATGGCGTG
GCAGACACGATCAAGTCACAAAGG -> CAGACACGATCAAGTCACAAAGGT
ATGCCTCTTGCGTCTTTCATGAAT -> TGCCTCTTGCGTCTTTCATGAATT
GTTACGAACGCTCGCATGGCGTGC -> TTACGAACGCTCGCATGGCGTGCA
GCCGTGGGCCGCTGATCGTGTTAG -> CCGTGGGCCGCTGATCGTGTTAGA
TATAGGCTTCTAGAATCAAGAATC -> ATAGGCTTCTAGAATCAAGAATCT
CGTTGTGACCGACCTAAAAGAATA -> GTTGTGACCGACCTAAAAGAATAT
GTCTTAATACTGAAAGTGTCTGGT -> TCTTAATACTGAAAGTGTCTGGTA
TCAATATTCCCGTTCGGTGGGCTT -> CAATATTCCCGTTCGGTGGGCTTC
AGCGAAGGGGTGATGCGCTCGATT -> GCGAAGGGGTGATGCGCTCGATTA
TCAGTTAACACGAAATGACCGGGA -> CAGTTAACACGAAATGACCGGGAT
TCTAATACGCTATATAATTTGCAG -> CTAATACGCTATATAATTTGCAGC
GGAGGTTTATCGCGCCAAATAGCG -> GAGGTTTATCGCGCCAAATAGCGG
GGAGGTTTTGCCTGTAAAGCGAAG -> GAGGTTTTGCCTGTAAAGCGAAGG
CTTCAAAACGACTTAGAGGAATGG -> TTCAAAACGACTTAGAGGAATGGG
TCTCAATATTCCCGTTCGGTGGGC -> CTCAATATTCCCGTTCGGTGGGCT
ACCTAAAAGAATATGCGTCCTTCT -> CCTAAAAGAATATGCGTCCTTCTG
GGGCCGCTGATCGTGTTAGAGAAA -> GGCCGCTGATCGTGTTAGAGAAAA
CGAGTGTTAACCCGATGGAACTTG -> GAGTGTTAACCCGATGGAACTTGT
CGTGATGCCTGGTAAGCAGTTTGG -> GTGATGCCTGGTAAGCAGTTTGGG
TTATGTCGAAACGATGGCTTGAAC -> TATGTCGAAACGATGGCTTGAACC
TTATAGGCTTCTAGAATCAAGAAT -> TATAGGCTTCTAGAATCAAGAATC
GGTATCATAAAACAGTGCAGCAAT -> GTATCATAAAACAGTGCAGCAATA
CGCCAAATAGCGGGCACCACACGT -> GCCAAATAGCGGGCACCACACGTG
AGAAAGAAAGCTACGCTGAATAAA -> GAAAGAAAGCTACGCTGAATAAAC
GTAATTGGGCGCCCCAAGCCAAGG -> TAATTGGGCGCCCCAAGCCAAGGA
AACTCCCATGTGCGGTTCCCTCCA -> ACTCCCATGTGCGGTTCCCTCCAT
GGCACTGCCCTAGATTTCAACCAT -> GCACTGCCCTAGATTTCAACCATG
ATGACTCAAACAGCGAAGGATAAG -> TGACTCAAACAGCGAAGGATAAGC
GACCATCACCTTCACCATCCTCGA -> ACCATCACCTTCACCATCCTCGAG
CTGTTATGCCTCTTGCGTCTTTCA -> TGTTATGCCTCTTGCGTCTTTCAT
TCCAGGAGTTCGTTATGGATTCGT -> CCAGGAGTTCGTTATGGATTCGTT
GCCAAATGCTGCAGTCCATTTGCT -> CCAAATGCTGCAGTCCATTTGCTT
ACTCAACTAGACAGCGCCTGACCA -> CTCAACTAGACAGCGCCTGACCAT
GCGTCGAAGTAGACTCCTCCAAAG -> CGTCGAAGTAGACTCCTCCAAAGC
CCGGTCGTCGAGTGACGTACTCAA -> CGGTCGTCGAGTGACGTACTCAAC
CCGTTAACCTCTCGTCTGATGCGC -> CGTTAACCTCTCGTCTGATGCGCA
GGAGGGGTGTAAGCATGATATACC -> GAGGGGTGTAAGCATGATATACCA
GCGACTCGTAAACGAAGGCTTCAT -> CGACTCGTAAACGAAGGCTTCATT
AACCCGATGGAACTTGTCCCTTAT -> ACCCGATGGAACTTGTCCCTTATG
GGATGGCTCTCAATATTCCCGTTC -> GATGGCTCTCAATATTCCCGTTCG
TCAAGTCACAAAGGTATGACACCA -> CAAGTCACAAAGGTATGACACCAA
TATCGCGCCAAATAGCGGGCACCA -> ATCGCGCCAAATAGCGGGCACCAC
CGGATTTGTGCCAAATGCTGCAGT -> GGATTTGTGCCAAATGCTGCAGTC
AGACAGCGCCTGACCATCACCTTC -> GACAGCGCCTGACCATCACCTTCA
CCAACAAACAGCCAACTCCCATGT -> CAACAAACAGCCAACTCCCATGTG
GGTGTAAGCATGATATACCATAGA -> GTGTAAGCATGATATACCATAGAC
GTATCAGTCCCGACCGCTACGTGC -> TATCAGTCCCGACCGCTACGTGCG
GTAGCCTGAGAAAGAAAGCTACGC -> TAGCCTGAGAAAGAAAGCTACGCT
GCTTGAACCTCTGCTTAGATGTTA -> CTTGAACCTCTGCTTAGATGTTAC
ACCTACTTCAAAACGACTTAGAGG -> CCTACTTCAAAACGACTTAGAGGA
CGTCGAGTGACGTACTCAACTAGA -> GTCGAGTGACGTACTCAACTAGAC
CATGTCCCGCGTTCCCGCGGGATG -> ATGTCCCGCGTTCCCGCGGGATGA
GGCACCACACGTGGATGCCCGGTC -> GCACCACACGTGGATGCCCGGTCG
ATCAAGAATCTGAGACGTTGTGAC -> TCAAGAATCTGAGACGTTGTGACC
GGGTGATGCGCTCGATTAGTTGAG -> GGTGATGCGCTCGATTAGTTGAGC
TTGGGCGCCCCAAGCCAAGGATGA -> TGGGCGCCCCAAGCCAAGGATGAT
CCACGCAGTTCGGAGCTTAATACC -> CACGCAGTTCGGAGCTTAATACCT
CGGCCCGTAGCCTGAGAAAGAAAG -> GGCCCGTAGCCTGAGAAAGAAAGC
CAGTGTTGAGTGGGGACGAAAATG -> AGTGTTGAGTGGGGACGAAAATGG
AACTAGACAGCGCCTGACCATCAC -> ACTAGACAGCGCCTGACCATCACC
ATGAGGCGTCAGCCGAAACTTTAT -> TGAGGCGTCAGCCGAAACTTTATT
CGGTTCCCTCCATAGGTACGCCCC -> GGTTCCCTCCATAGGTACGCCCCG
CGGTTGCGGCCCGTAGCCTGAGAA -> GGTTGCGGCCCGTAGCCTGAGAAA
GTTATGCCTCTTGCGTCTTTCATG -> TTATGCCTCTTGCGTCTTTCATGA
TGCGGTTCCCTCCATAGGTACGCC -> GCGGTTCCCTCCATAGGTACGCCC
GTGTCTGGTATCATAAAACAGTGC -> TGTCTGGTATCATAAAACAGTGCA
AGGATGATAGCAACACCTGTTATA -> GGATGATAGCAACACCTGTTATAG
GGGAGCCACATGAGAAACCTAGTA -> GGAGCCACATGAGAAACCTAGTAT
CATGTGCGGTTCCCTCCATAGGTA -> ATGTGCGGTTCCCTCCATAGGTAC
AACGATGGCTTGAACCTCTGCTTA -> ACGATGGCTTGAACCTCTGCTTAG
AAGTAATAGTAGTGCAGGCGGTTG -> AGTAATAGTAGTGCAGGCGGTTGC
GAGGTTTTGCCTGTAAAGCGAAGG -> AGGTTTTGCCTGTAAAGCGAAGGG
GAGGAATGGGCCGTTAACCTCTCG -> AGGAATGGGCCGTTAACCTCTCGT
GACACTGGAACGTCCGGTGACTGT -> ACACTGGAACGTCCGGTGACTGTT
CCCGTTCGGTGGGCTTCGGGTTCT -> CCGTTCGGTGGGCTTCGGGTTCTC
CCCTTTGTCGGCATGTCTAAGCTT -> CCTTTGTCGGCATGTCTAAGCTTG
TCAGTTTTGAACCCTCACACCGGT -> CAGTTTTGAACCCTCACACCGGTG
TCTGGGATAAGTTCGCATCGGGCG -> CTGGGATAAGTTCGCATCGGGCGC
TCGCATGGCGTGCAGGTGTATAGC -> CGCATGGCGTGCAGGTGTATAGCT
AGAGGAATGGGCCGTTAACCTCTC -> GAGGAATGGGCCGTTAACCTCTCG
TGATGCCTGGTAAGCAGTTTGGGG -> GATGCCTGGTAAGCAGTTTGGGGC
TAGCCTGAGAAAGAAAGCTACGCT -> AGCCTGAGAAAGAAAGCTACGCTG
ATCAGTCCCGACCGCTACGTGCGG -> TCAGTCCCGACCGCTACGTGCGGA
TCGCGACTCGTAAACGAAGGCTTC -> CGCGACTCGTAAACGAAGGCTTCA
CAAGTAATAGTAGTGCAGGCGGTT -> AAGTAATAGTAGTGCAGGCGGTTG
TGAGGCGTCAGCCGAAACTTTATT -> GAGGCGTCAGCCGAAACTTTATTC
TACGTGCGGACCTAGTTCAGTAAC -> ACGTGCGGACCTAGTTCAGTAACA
GATCACGGATACTTGTCGTAACTA -> ATCACGGATACTTGTCGTAACTAC
TAGTCGTTACTTGGTGGGAGCACG -> AGTCGTTACTTGGTGGGAGCACGA
TATAGCTCTGTTAGTCGACGCCTG -> ATAGCTCTGTTAGTCGACGCCTGC
GACCAGGCGTCGCGACTCGTAAAC -> ACCAGGCGTCGCGACTCGTAAACG
ATCCCTACTACCAACGACAACTCG -> TCCCTACTACCAACGACAACTCGG
TTTTCCGTCGCTGTCTTCTGGCAA -> TTTCCGTCGCTGTCTTCTGGCAAG
CAGTCCCGACCGCTACGTGCGGAC -> AGTCCCGACCGCTACGTGCGGACC
AAGCCTCCACGCAGTTCGGAGCTT -> AGCCTCCACGCAGTTCGGAGCTTA
ACTTGGTGGGAGCACGACTAATCC -> CTTGGTGGGAGCACGACTAATCCT
TATTTCGGATTTGTGCCAAATGCT -> ATTTCGGATTTGTGCCAAATGCTG
GCGATCACGGATACTTGTCGTAAC -> CGATCACGGATACTTGTCGTAACT
CGTCGCTGTCTTCTGGCAAGTAAT -> GTCGCTGTCTTCTGGCAAGTAATA
TGTGACCGACCTAAAAGAATATGC -> GTGACCGACCTAAAAGAATATGCG
AGGCGTCGCGACTCGTAAACGAAG -> GGCGTCGCGACTCGTAAACGAAGG
ACACCTGTTATAGGCTTCTAGAAT -> CACCTGTTATAGGCTTCTAGAATC
ATCGCAGGAGGTTTATCGCGCCAA -> TCGCAGGAGGTTTATCGCGCCAAA
CATTAGTCGTTACTTGGTGGGAGC -> ATTAGTCGTTACTTGGTGGGAGCA
TCGTGCCGTGGGCCGCTGATCGTG -> CGTGCCGTGGGCCGCTGATCGTGT
ACCCGATGGAACTTGTCCCTTATG -> CCCGATGGAACTTGTCCCTTATGA
CAGCCAACTCCCATGTGCGGTTCC -> AGCCAACTCCCATGTGCGGTTCCC
ACGAAGCAGACATAATGCACTCTG -> CGAAGCAGACATAATGCACTCTGG
ATGGATTCGTTATGTCGAAACGAT -> TGGATTCGTTATGTCGAAACGATG
CTGCCTCTCCAGGAGTTCGTTATG -> TGCCTCTCCAGGAGTTCGTTATGG
GAAACCTAGTATCGCAGGAGGTTT -> AAACCTAGTATCGCAGGAGGTTTA
TGACTGTTATGCCTCTTGCGTCTT -> GACTGTTATGCCTCTTGCGTCTTT
ACCATAGACTTAGGACGGAAGTTT -> CCATAGACTTAGGACGGAAGTTTC
TTAACTCGTCTTAATACTGAAAGT -> TAACTCGTCTTAATACTGAAAGTG
TCGACGCCTGCCTCTCCAGGAGTT -> CGACGCCTGCCTCTCCAGGAGTTC
AGACTTAGGACGGAAGTTTCCTAT -> GACTTAGGACGGAAGTTTCCTATC
TCCCGCGGGATGAGATATTTCGGA -> CCCGCGGGATGAGATATTTCGGAT
AGTGTTAACCCGATGGAACTTGTC -> GTGTTAACCCGATGGAACTTGTCC
GACGTACTCAACTAGACAGCGCCT -> ACGTACTCAACTAGACAGCGCCTG
AAGCAGTTTGGGGCAGACACGATC -> AGCAGTTTGGGGCAGACACGATCA
TGCAGCAATATCCCGTCATAGTTA -> GCAGCAATATCCCGTCATAGTTAC
CAACTCCCATGTGCGGTTCCCTCC -> AACTCCCATGTGCGGTTCCCTCCA
AAAAGAATATGCGTCCTTCTGTGC -> AAAGAATATGCGTCCTTCTGTGCC
CAACAAACAGCCAACTCCCATGTG -> AACAAACAGCCAACTCCCATGTGC
ACGCACCCCCAACAAACAGCCAAC -> CGCACCCCCAACAAACAGCCAACT
CAACAGCCGGTCTCCCTTTGTCGG -> AACAGCCGGTCTCCCTTTGTCGGC
ACCATCACCTTCACCATCCTCGAG -> CCATCACCTTCACCATCCTCGAGT
ATAAGCGACGCAACAGCCGGTCTC -> TAAGCGACGCAACAGCCGGTCTCC
CGCACTAGTGTTTGGCGGGAGGGG -> GCACTAGTGTTTGGCGGGAGGGGT
CGTCTGACACTGGAACGTCCGGTG -> GTCTGACACTGGAACGTCCGGTGA
TTCGGAGCTTAATACCTACTTCAA -> TCGGAGCTTAATACCTACTTCAAA
TATCTAATACGCTATATAATTTGC -> ATCTAATACGCTATATAATTTGCA
TTGGCGGGAGGGGTGTAAGCATGA -> TGGCGGGAGGGGTGTAAGCATGAT
TGACAGCACGGACTTAGCCTGCGT -> GACAGCACGGACTTAGCCTGCGTA
CAAGTCGTGCCGTGGGCCGCTGAT -> AAGTCGTGCCGTGGGCCGCTGATC
GATGGCTCTCAATATTCCCGTTCG -> ATGGCTCTCAATATTCCCGTTCGG
TTTGAACCCTCACACCGGTGCACA -> TTGAACCCTCACACCGGTGCACAG
AGATATTTCGGATTTGTGCCAAAT -> GATATTTCGGATTTGTGCCAAATG
CGAGTCCGTGATGCCTGGTAAGCA -> GAGTCCGTGATGCCTGGTAAGCAG
TGCCCCGGCCCTCGCTTAATTGCA -> GCCCCGGCCCTCGCTTAATTGCAC
GCAGCTTATAATGCGATCACGGAT -> CAGCTTATAATGCGATCACGGATA
AGTTCGCATCGGGCGCCTAGAAGC -> GTTCGCATCGGGCGCCTAGAAGCA
GGTGCACAGTGTTGAGTGGGGACG -> GTGCACAGTGTTGAGTGGGGACGA
GGCGGGAGGGGTGTAAGCATGATA -> GCGGGAGGGGTGTAAGCATGATAT
CATAGTGCGTCGAAGTAGACTCCT -> ATAGTGCGTCGAAGTAGACTCCTC
CTGCGTATCAGTCCCGACCGCTAC -> TGCGTATCAGTCCCGACCGCTACG
TGAATAAACAGTCTTAACTTATCG -> GAATAAACAGTCTTAACTTATCGA
GGTGGGAGCACGACTAATCCTCGG -> GTGGGAGCACGACTAATCCTCGGA
TTTGCCTGTAAAGCGAAGGGGTGA -> TTGCCTGTAAAGCGAAGGGGTGAT
TGGGCGCCCCAAGCCAAGGATGAT -> GGGCGCCCCAAGCCAAGGATGATA
TGAGACGTTGTGACCGACCTAAAA -> GAGACGTTGTGACCGACCTAAAAG
CTCTCCAGGAGTTCGTTATGGATT -> TCTCCAGGAGTTCGTTATGGATTC
GTCGTCGAGTGACGTACTCAACTA -> TCGTCGAGTGACGTACTCAACTAG
GAAGTTGAGTTCTGGGATAAGTTC -> AAGTTGAGTTCTGGGATAAGTTCG
ACGCTCGCATGGCGTGCAGGTGTA -> CGCTCGCATGGCGTGCAGGTGTAT
ACGCCCCGATCGCATATCCTAGCA -> CGCCCCGATCGCATATCCTAGCAG
CATATCCTAGCAGCGACCAGGCGT -> ATATCCTAGCAGCGACCAGGCGTC
AGCGAAGGATAAGCGACGCAACAG -> GCGAAGGATAAGCGACGCAACAGC
AGCTTATAATGCGATCACGGATAC -> GCTTATAATGCGATCACGGATACT
AACCTAGTATCGCAGGAGGTTTAT -> ACCTAGTATCGCAGGAGGTTTATC
CGGCATGTCTAAGCTTGCTGGGCT -> GGCATGTCTAAGCTTGCTGGGCTC
TTCCCTCCATAGGTACGCCCCGAT -> TCCCTCCATAGGTACGCCCCGATC
GACATCCCTACTACCAACGACAAC -> ACATCCCTACTACCAACGACAACT
ATTAGTCGTTACTTGGTGGGAGCA -> TTAGTCGTTACTTGGTGGGAGCAC
TTAGCCTGCGTATCAGTCCCGACC -> TAGCCTGCGTATCAGTCCCGACCG
ATAGGTACGCCCCGATCGCATATC -> TAGGTACGCCCCGATCGCATATCC
TTCGGTGGGCTTCGGGTTCTCCGT -> TCGGTGGGCTTCGGGTTCTCCGTC
AGAGAAAACACACGGCGATGAGGC -> GAGAAAACACACGGCGATGAGGCG
AACTTTATTCAGTTAACACGAAAT -> ACTTTATTCAGTTAACACGAAATG
AAGAAAGCTACGCTGAATAAACAG -> AGAAAGCTACGCTGAATAAACAGT
GACTGTTATGCCTCTTGCGTCTTT -> ACTGTTATGCCTCTTGCGTCTTTC
ACTCGTAAACGAAGGCTTCATTAG -> CTCGTAAACGAAGGCTTCATTAGT
GAAAGCTACGCTGAATAAACAGTC -> AAAGCTACGCTGAATAAACAGTCT
TGCGTCCTTCTGTGCCCCGGCCCT -> GCGTCCTTCTGTGCCCCGGCCCTC
TTAGAGGAATGGGCCGTTAACCTC -> TAGAGGAATGGGCCGTTAACCTCT
AAAGGTATGACACCAAAAGAAGTT -> AAGGTATGACACCAAAAGAAGTTG
TCCCGCGTTCCCGCGGGATGAGAT -> CCCGCGTTCCCGCGGGATGAGATA
GATGAGGCGTCAGCCGAAACTTTA -> ATGAGGCGTCAGCCGAAACTTTAT
AAAGTGTCTGGTATCATAAAACAG -> AAGTGTCTGGTATCATAAAACAGT
GTCGTAACTACGCACCCCCAACAA -> TCGTAACTACGCACCCCCAACAAA
AAAGCTACGCTGAATAAACAGTCT -> AAGCTACGCTGAATAAACAGTCTT
CGGGTTCTCCGTCTGACACTGGAA -> GGGTTCTCCGTCTGACACTGGAAC
ATATGCGTCCTTCTGTGCCCCGGC -> TATGCGTCCTTCTGTGCCCCGGCC
GTGTTGAGTGGGGACGAAAATGGC -> TGTTGAGTGGGGACGAAAATGGCA
ATTTCAACCATGACAGCACGGACT -> TTTCAACCATGACAGCACGGACTT
CACGGATACTTGTCGTAACTACGC -> ACGGATACTTGTCGTAACTACGCA
CGACTCGTAAACGAAGGCTTCATT -> GACTCGTAAACGAAGGCTTCATTA
CACGTGGATGCCCGGTCGTCGAGT -> ACGTGGATGCCCGGTCGTCGAGTG
GGATGATAGCAACACCTGTTATAG -> GATGATAGCAACACCTGTTATAGG
GATTTGTGCCAAATGCTGCAGTCC -> ATTTGTGCCAAATGCTGCAGTCCA
AAGTTGAGTTCTGGGATAAGTTCG -> AGTTGAGTTCTGGGATAAGTTCGC
CCCGATGGAACTTGTCCCTTATGA -> CCGATGGAACTTGTCCCTTATGAC
CAGACACGATCAAGTCACAAAGGT -> AGACACGATCAAGTCACAAAGGTA
TCCCATGTGCGGTTCCCTCCATAG -> CCCATGTGCGGTTCCCTCCATAGG
CGTGGATGCCCGGTCGTCGAGTGA -> GTGGATGCCCGGTCGTCGAGTGAC
TCTCGGTAATTGGGCGCCCCAAGC -> CTCGGTAATTGGGCGCCCCAAGCC
TTAATACTGAAAGTGTCTGGTATC -> TAATACTGAAAGTGTCTGGTATCA
TGGGCCGCTGATCGTGTTAGAGAA -> GGGCCGCTGATCGTGTTAGAGAAA
TCACCATCCTCGAGTCCGTGATGC -> CACCATCCTCGAGTCCGTGATGCC
ACACGAAATGACCGGGATTAACTC -> CACGAAATGACCGGGATTAACTCG
TGGGATAAGTTCGCATCGGGCGCC -> GGGATAAGTTCGCATCGGGCGCCT
TCATGAATTGACGGCAGGCGTTGT -> CATGAATTGACGGCAGGCGTTGTC
CGCAGGAGGTTTATCGCGCCAAAT -> GCAGGAGGTTTATCGCGCCAAATA
CTAGATTTCAACCATGACAGCACG -> TAGATTTCAACCATGACAGCACGG
ACCTAGTTCAGTAACAAGTCGTGC -> CCTAGTTCAGTAACAAGTCGTGCC
TCCATTTGCTTTGGAGGTTTTGCC -> CCATTTGCTTTGGAGGTTTTGCCT
ACAGCCGGTCTCCCTTTGTCGGCA -> CAGCCGGTCTCCCTTTGTCGGCAT
TTGCAGCTTATAATGCGATCACGG -> TGCAGCTTATAATGCGATCACGGA
TGCGTATCAGTCCCGACCGCTACG -> GCGTATCAGTCCCGACCGCTACGT
GTATGACACCAAAAGAAGTTGAGT -> TATGACACCAAAAGAAGTTGAGTT
GTTAGAGAAAACACACGGCGATGA -> TTAGAGAAAACACACGGCGATGAG
CCGATGGAACTTGTCCCTTATGAC -> CGATGGAACTTGTCCCTTATGACT
CAAAACGACTTAGAGGAATGGGCC -> AAAACGACTTAGAGGAATGGGCCG
GGAAGTTTCCTATCTAATACGCTA -> GAAGTTTCCTATCTAATACGCTAT
ATGCGTCCTTCTGTGCCCCGGCCC -> TGCGTCCTTCTGTGCCCCGGCCCT
CGGGATTAACTCGTCTTAATACTG -> GGGATTAACTCGTCTTAATACTGA
TTCGTTATGGATTCGTTATGTCGA -> TCGTTATGGATTCGTTATGTCGAA
CGCCTGACCATCACCTTCACCATC -> GCCTGACCATCACCTTCACCATCC
TAAGCAGTTTGGGGCAGACACGAT -> AAGCAGTTTGGGGCAGACACGATC
CACAAAGATGTCAGTTTTGAACCC -> ACAAAGATGTCAGTTTTGAACCCT
GATGAGATATTTCGGATTTGTGCC -> ATGAGATATTTCGGATTTGTGCCA
TCCCTCCATAGGTACGCCCCGATC -> CCCTCCATAGGTACGCCCCGATCG
CCGACCTAAAAGAATATGCGTCCT -> CGACCTAAAAGAATATGCGTCCTT
GCCCCGGCCCTCGCTTAATTGCAC -> CCCCGGCCCTCGCTTAATTGCACG
GACGTTGTGACCGACCTAAAAGAA -> ACGTTGTGACCGACCTAAAAGAAT
CCTAGCAGCGACCAGGCGTCGCGA -> CTAGCAGCGACCAGGCGTCGCGAC
GACTTAGCCTGCGTATCAGTCCCG -> ACTTAGCCTGCGTATCAGTCCCGA
TGCGATCACGGATACTTGTCGTAA -> GCGATCACGGATACTTGTCGTAAC
TAGCTCTGTTAGTCGACGCCTGCC -> AGCTCTGTTAGTCGACGCCTGCCT
AGGAGTTCGTTATGGATTCGTTAT -> GGAGTTCGTTATGGATTCGTTATG
AATTGCACGAAGCAGACATAATGC -> ATTGCACGAAGCAGACATAATGCA
AGTAGACATCCCTACTACCAACGA -> GTAGACATCCCTACTACCAACGAC
GCTCGATTAGTTGAGCATAGTGCG -> CTCGATTAGTTGAGCATAGTGCGT
GTAAACGAAGGCTTCATTAGTCGT -> TAAACGAAGGCTTCATTAGTCGTT
AAACAGCGAAGGATAAGCGACGCA -> AACAGCGAAGGATAAGCGACGCAA
TCTGTGCCCCGGCCCTCGCTTAAT -> CTGTGCCCCGGCCCTCGCTTAATT
GCTGATCGTGTTAGAGAAAACACA -> CTGATCGTGTTAGAGAAAACACAC
ACAGCCAACTCCCATGTGCGGTTC -> CAGCCAACTCCCATGTGCGGTTCC
ATACCTACTTCAAAACGACTTAGA -> TACCTACTTCAAAACGACTTAGAG
AACGACAACTCGGGGAGCCACATG -> ACGACAACTCGGGGAGCCACATGA
CGGTGCACAGTGTTGAGTGGGGAC -> GGTGCACAGTGTTGAGTGGGGACG
GGGGCAGACACGATCAAGTCACAA -> GGGCAGACACGATCAAGTCACAAA
CGAAGTATCGCACTAGTGTTTGGC -> GAAGTATCGCACTAGTGTTTGGCG
GGGCCGTTAACCTCTCGTCTGATG -> GGCCGTTAACCTCTCGTCTGATGC
TATCAGTCCCGACCGCTACGTGCG -> ATCAGTCCCGACCGCTACGTGCGG
CACGATCAAGTCACAAAGGTATGA -> ACGATCAAGTCACAAAGGTATGAC
GTGCCGTGGGCCGCTGATCGTGTT -> TGCCGTGGGCCGCTGATCGTGTTA
TGAAAGTGTCTGGTATCATAAAAC -> GAAAGTGTCTGGTATCATAAAACA
AGGCGTCAGCCGAAACTTTATTCA -> GGCGTCAGCCGAAACTTTATTCAG
GAGTGACGTACTCAACTAGACAGC -> AGTGACGTACTCAACTAGACAGCG
TTTGGCGGGAGGGGTGTAAGCATG -> TTGGCGGGAGGGGTGTAAGCATGA
GCTTAGATGTTACATCGGTAGAAG -> CTTAGATGTTACATCGGTAGAAGA
GTAGACATCCCTACTACCAACGAC -> TAGACATCCCTACTACCAACGACA
AGCATGATATACCATAGACTTAGG -> GCATGATATACCATAGACTTAGGA
CAGCGACCAGGCGTCGCGACTCGT -> AGCGACCAGGCGTCGCGACTCGTA
AGACATAATGCACTCTGGAGCACA -> GACATAATGCACTCTGGAGCACAA
GGTTTTGCCTGTAAAGCGAAGGGG -> GTTTTGCCTGTAAAGCGAAGGGGT
GTTAACCCGATGGAACTTGTCCCT -> TTAACCCGATGGAACTTGTCCCTT
GAAGGCTTCATTAGTCGTTACTTG -> AAGGCTTCATTAGTCGTTACTTGG
CAGCGAAGGATAAGCGACGCAACA -> AGCGAAGGATAAGCGACGCAACAG
CAATATTCCCGTTCGGTGGGCTTC -> AATATTCCCGTTCGGTGGGCTTCG
GTAGAAGACTGTTTTCCGTCGCTG -> TAGAAGACTGTTTTCCGTCGCTGT
GACCACAAAGATGTCAGTTTTGAA -> ACCACAAAGATGTCAGTTTTGAAC
AAATGCTGCAGTCCATTTGCTTTG -> AATGCTGCAGTCCATTTGCTTTGG
GCGGGAGGGGTGTAAGCATGATAT -> CGGGAGGGGTGTAAGCATGATATA
GGCCCGTAGCCTGAGAAAGAAAGC -> GCCCGTAGCCTGAGAAAGAAAGCT
TGCCCGGTCGTCGAGTGACGTACT -> GCCCGGTCGTCGAGTGACGTACTC
TTCCCGTTCGGTGGGCTTCGGGTT -> TCCCGTTCGGTGGGCTTCGGGTTC
TGTCTAAGCTTGCTGGGCTCGAAG -> GTCTAAGCTTGCTGGGCTCGAAGT
GAACGTCCGGTGACTGTTATGCCT -> AACGTCCGGTGACTGTTATGCCTC
TACGAACGCTCGCATGGCGTGCAG -> ACGAACGCTCGCATGGCGTGCAGG
CCAGGAGTTCGTTATGGATTCGTT -> CAGGAGTTCGTTATGGATTCGTTA
ACCATCCTCGAGTCCGTGATGCCT -> CCATCCTCGAGTCCGTGATGCCTG
TGATATACCATAGACTTAGGACGG -> GATATACCATAGACTTAGGACGGA
TGACCATCACCTTCACCATCCTCG -> GACCATCACCTTCACCATCCTCGA
CAAATGCTGCAGTCCATTTGCTTT -> AAATGCTGCAGTCCATTTGCTTTG
CGTGTTAGAGAAAACACACGGCGA -> GTGTTAGAGAAAACACACGGCGAT
GGGGACGAAAATGGCACTGCCCTA -> GGGACGAAAATGGCACTGCCCTAG
CGTGCCGTGGGCCGCTGATCGTGT -> GTGCCGTGGGCCGCTGATCGTGTT
ACTACCAACGACAACTCGGGGAGC -> CTACCAACGACAACTCGGGGAGCC
TATGTCGAAACGATGGCTTGAACC -> ATGTCGAAACGATGGCTTGAACCT
CAAGGATGATAGCAACACCTGTTA -> AAGGATGATAGCAACACCTGTTAT
AGAATCTGAGACGTTGTGACCGAC -> GAATCTGAGACGTTGTGACCGACC
AATATCCCGTCATAGTTACGAACG -> ATATCCCGTCATAGTTACGAACGC
AACCTCTCGTCTGATGCGCACTTT -> ACCTCTCGTCTGATGCGCACTTTC
ACAACTCGGGGAGCCACATGAGAA -> CAACTCGGGGAGCCACATGAGAAA
CGCATCGGGCGCCTAGAAGCATCC -> GCATCGGGCGCCTAGAAGCATCCG
CCCCAAGCCAAGGATGATAGCAAC -> CCCAAGCCAAGGATGATAGCAACA
TCTGTTAGTCGACGCCTGCCTCTC -> CTGTTAGTCGACGCCTGCCTCTCC
ACTCAAACAGCGAAGGATAAGCGA -> CTCAAACAGCGAAGGATAAGCGAC
AGGCGGTTGCGGCCCGTAGCCTGA -> GGCGGTTGCGGCCCGTAGCCTGAG
CTACTACCAACGACAACTCGGGGA -> TACTACCAACGACAACTCGGGGAG
CCCATGTGCGGTTCCCTCCATAGG -> CCATGTGCGGTTCCCTCCATAGGT
GACTTAGAGGAATGGGCCGTTAAC -> ACTTAGAGGAATGGGCCGTTAACC
CTGGGCTCGAAGTATCGCACTAGT -> TGGGCTCGAAGTATCGCACTAGTG
CACATGAGAAACCTAGTATCGCAG -> ACATGAGAAACCTAGTATCGCAGG
ATGAGAAACCTAGTATCGCAGGAG -> TGAGAAACCTAGTATCGCAGGAGG
AGTGCAGCAATATCCCGTCATAGT -> GTGCAGCAATATCCCGTCATAGTT
TAAGTTCGCATCGGGCGCCTAGAA -> AAGTTCGCATCGGGCGCCTAGAAG
GATACTTGTCGTAACTACGCACCC -> ATACTTGTCGTAACTACGCACCCC
ACGCTATATAATTTGCAGCTTATA -> CGCTATATAATTTGCAGCTTATAA
AGGGGTGATGCGCTCGATTAGTTG -> GGGGTGATGCGCTCGATTAGTTGA
CCGTGACCACAAAGATGTCAGTTT -> CGTGACCACAAAGATGTCAGTTTT
TAGACTCCTCCAAAGCCTCCACGC -> AGACTCCTCCAAAGCCTCCACGCA
ACAGCGAAGGATAAGCGACGCAAC -> CAGCGAAGGATAAGCGACGCAACA
TAGTGCGTCGAAGTAGACTCCTCC -> AGTGCGTCGAAGTAGACTCCTCCA
GCTTCGGGTTCTCCGTCTGACACT -> CTTCGGGTTCTCCGTCTGACACTG
CTCCCTTTGTCGGCATGTCTAAGC -> TCCCTTTGTCGGCATGTCTAAGCT
TCATGTCCCGCGTTCCCGCGGGAT -> CATGTCCCGCGTTCCCGCGGGATG
GTAGTGCAGGCGGTTGCGGCCCGT -> TAGTGCAGGCGGTTGCGGCCCGTA
GGTATGACACCAAAAGAAGTTGAG -> GTATGACACCAAAAGAAGTTGAGT
CAAACAGCGAAGGATAAGCGACGC -> AAACAGCGAAGGATAAGCGACGCA
TGAACCTCTGCTTAGATGTTACAT -> GAACCTCTGCTTAGATGTTACATC
AATACCGAGTGTTAACCCGATGGA -> ATACCGAGTGTTAACCCGATGGAA
TATGCGTCCTTCTGTGCCCCGGCC -> ATGCGTCCTTCTGTGCCCCGGCCC
GGATTAACTCGTCTTAATACTGAA -> GATTAACTCGTCTTAATACTGAAA
GTCGAAGTAGACTCCTCCAAAGCC -> TCGAAGTAGACTCCTCCAAAGCCT
AAAGAATATGCGTCCTTCTGTGCC -> AAGAATATGCGTCCTTCTGTGCCC
TGGCGGGAGGGGTGTAAGCATGAT -> GGCGGGAGGGGTGTAAGCATGATA
ACATGAGAAACCTAGTATCGCAGG -> CATGAGAAACCTAGTATCGCAGGA
AACTACGCACCCCCAACAAACAGC -> ACTACGCACCCCCAACAAACAGCC
GGCAAGTAATAGTAGTGCAGGCGG -> GCAAGTAATAGTAGTGCAGGCGGT
AACAAGTCGTGCCGTGGGCCGCTG -> ACAAGTCGTGCCGTGGGCCGCTGA
GAATCTGAGACGTTGTGACCGACC -> AATCTGAGACGTTGTGACCGACCT
GAGTGGGGACGAAAATGGCACTGC -> AGTGGGGACGAAAATGGCACTGCC
GCACGGACTTAGCCTGCGTATCAG -> CACGGACTTAGCCTGCGTATCAGT
CGAAGCAGACATAATGCACTCTGG -> GAAGCAGACATAATGCACTCTGGA
GAATATGCGTCCTTCTGTGCCCCG -> AATATGCGTCCTTCTGTGCCCCGG
ATCCTAGCAGCGACCAGGCGTCGC -> TCCTAGCAGCGACCAGGCGTCGCG
GCCTCTCCAGGAGTTCGTTATGGA -> CCTCTCCAGGAGTTCGTTATGGAT
GCAGGCGGTTGCGGCCCGTAGCCT -> CAGGCGGTTGCGGCCCGTAGCCTG
TGCAGCTTATAATGCGATCACGGA -> GCAGCTTATAATGCGATCACGGAT
GCCGGTCTCCCTTTGTCGGCATGT -> CCGGTCTCCCTTTGTCGGCATGTC
GTTACTTGGTGGGAGCACGACTAA -> TTACTTGGTGGGAGCACGACTAAT
AGTGTCTGGTATCATAAAACAGTG -> GTGTCTGGTATCATAAAACAGTGC
CGGCAGGCGTTGTCATGTCCCGCG -> GGCAGGCGTTGTCATGTCCCGCGT
AATACCTACTTCAAAACGACTTAG -> ATACCTACTTCAAAACGACTTAGA
TCTTGCGTCTTTCATGAATTGACG -> CTTGCGTCTTTCATGAATTGACGG
CACCTGTTATAGGCTTCTAGAATC -> ACCTGTTATAGGCTTCTAGAATCA
ATTGACGGCAGGCGTTGTCATGTC -> TTGACGGCAGGCGTTGTCATGTCC
ACACCAAAAGAAGTTGAGTTCTGG -> CACCAAAAGAAGTTGAGTTCTGGG
CGTCCGGTGACTGTTATGCCTCTT -> GTCCGGTGACTGTTATGCCTCTTG
ATGAGATATTTCGGATTTGTGCCA -> TGAGATATTTCGGATTTGTGCCAA
AAGTGTCTGGTATCATAAAACAGT -> AGTGTCTGGTATCATAAAACAGTG
GTGCGTCGAAGTAGACTCCTCCAA -> TGCGTCGAAGTAGACTCCTCCAAA
AGTTAACACGAAATGACCGGGATT -> GTTAACACGAAATGACCGGGATTA
CGCTCGATTAGTTGAGCATAGTGC -> GCTCGATTAGTTGAGCATAGTGCG
TGACACCAAAAGAAGTTGAGTTCT -> GACACCAAAAGAAGTTGAGTTCTG
GCTTATAATGCGATCACGGATACT -> CTTATAATGCGATCACGGATACTT
CGCTGAATAAACAGTCTTAACTTA -> GCTGAATAAACAGTCTTAACTTAT
TGTTTGGCGGGAGGGGTGTAAGCA -> GTTTGGCGGGAGGGGTGTAAGCAT
GTCAGCCGAAACTTTATTCAGTTA -> TCAGCCGAAACTTTATTCAGTTAA
GACTCAAACAGCGAAGGATAAGCG -> ACTCAAACAGCGAAGGATAAGCGA
CATGATATACCATAGACTTAGGAC -> ATGATATACCATAGACTTAGGACG
TTTTGAACCCTCACACCGGTGCAC -> TTTGAACCCTCACACCGGTGCACA
TCGAAGTATCGCACTAGTGTTTGG -> CGAAGTATCGCACTAGTGTTTGGC
GTTCGGTGGGCTTCGGGTTCTCCG -> TTCGGTGGGCTTCGGGTTCTCCGT
GGCGCCCCAAGCCAAGGATGATAG -> GCGCCCCAAGCCAAGGATGATAGC
GCGTGCAGGTGTATAGCTCTGTTA -> CGTGCAGGTGTATAGCTCTGTTAG
TGATGCGCACTTTCAGTAGACATC -> GATGCGCACTTTCAGTAGACATCC
TTGCGTCTTTCATGAATTGACGGC -> TGCGTCTTTCATGAATTGACGGCA
TCTCCGTCTGACACTGGAACGTCC -> CTCCGTCTGACACTGGAACGTCCG
CTCGATTAGTTGAGCATAGTGCGT -> TCGATTAGTTGAGCATAGTGCGTC
AAGGCTTCATTAGTCGTTACTTGG -> AGGCTTCATTAGTCGTTACTTGGT
TCCTTCTGTGCCCCGGCCCTCGCT -> CCTTCTGTGCCCCGGCCCTCGCTT
TCGCACTAGTGTTTGGCGGGAGGG -> CGCACTAGTGTTTGGCGGGAGGGG
TGCTGCAGTCCATTTGCTTTGGAG -> GCTGCAGTCCATTTGCTTTGGAGG
CGCCCCGATCGCATATCCTAGCAG -> GCCCCGATCGCATATCCTAGCAGC
AACACCTGTTATAGGCTTCTAGAA -> ACACCTGTTATAGGCTTCTAGAAT
AAAACGACTTAGAGGAATGGGCCG -> AAACGACTTAGAGGAATGGGCCGT
ACGCTGAATAAACAGTCTTAACTT -> CGCTGAATAAACAGTCTTAACTTA
CCTCTTGCGTCTTTCATGAATTGA -> CTCTTGCGTCTTTCATGAATTGAC
ACGTGGATGCCCGGTCGTCGAGTG -> CGTGGATGCCCGGTCGTCGAGTGA
TTAGTCGACGCCTGCCTCTCCAGG -> TAGTCGACGCCTGCCTCTCCAGGA
GACTCCTCCAAAGCCTCCACGCAG -> ACTCCTCCAAAGCCTCCACGCAGT
ACAAAGATGTCAGTTTTGAACCCT -> CAAAGATGTCAGTTTTGAACCCTC
AACGAAGGCTTCATTAGTCGTTAC -> ACGAAGGCTTCATTAGTCGTTACT
TACCAACGACAACTCGGGGAGCCA -> ACCAACGACAACTCGGGGAGCCAC
GTGTTAGAGAAAACACACGGCGAT -> TGTTAGAGAAAACACACGGCGATG
TTTCCTATCTAATACGCTATATAA -> TTCCTATCTAATACGCTATATAAT
TCGTAAACGAAGGCTTCATTAGTC -> CGTAAACGAAGGCTTCATTAGTCG
TCTCCCTTTGTCGGCATGTCTAAG -> CTCCCTTTGTCGGCATGTCTAAGC
ACTAGACAGCGCCTGACCATCACC -> CTAGACAGCGCCTGACCATCACCT
TAATAGTAGTGCAGGCGGTTGCGG -> AATAGTAGTGCAGGCGGTTGCGGC
GTTTTCCGTCGCTGTCTTCTGGCA -> TTTTCCGTCGCTGTCTTCTGGCAA
CTACGCACCCCCAACAAACAGCCA -> TACGCACCCCCAACAAACAGCCAA
TCGGTGGGCTTCGGGTTCTCCGTC -> CGGTGGGCTTCGGGTTCTCCGTCT
TAACTCGTCTTAATACTGAAAGTG -> AACTCGTCTTAATACTGAAAGTGT
CCTCCATAGGTACGCCCCGATCGC -> CTCCATAGGTACGCCCCGATCGCA
GCAGTCCATTTGCTTTGGAGGTTT -> CAGTCCATTTGCTTTGGAGGTTTT
GATTCGTTATGTCGAAACGATGGC -> ATTCGTTATGTCGAAACGATGGCT
TGGAGGTTTTGCCTGTAAAGCGAA -> GGAGGTTTTGCCTGTAAAGCGAAG
TTACTTGGTGGGAGCACGACTAAT -> TACTTGGTGGGAGCACGACTAATC
GGAGCTTAATACCTACTTCAAAAC -> GAGCTTAATACCTACTTCAAAACG
AGCTACGCTGAATAAACAGTCTTA -> GCTACGCTGAATAAACAGTCTTAA
ATACGCTATATAATTTGCAGCTTA -> TACGCTATATAATTTGCAGCTTAT
GATTAGTTGAGCATAGTGCGTCGA -> ATTAGTTGAGCATAGTGCGTCGAA
AACTTGTCCCTTATGACTCAAACA -> ACTTGTCCCTTATGACTCAAACAG
TTAATTGCACGAAGCAGACATAAT -> TAATTGCACGAAGCAGACATAATG
CAATACCGAGTGTTAACCCGATGG -> AATACCGAGTGTTAACCCGATGGA
ACCTGTTATAGGCTTCTAGAATCA -> CCTGTTATAGGCTTCTAGAATCAA
AGCAACACCTGTTATAGGCTTCTA -> GCAACACCTGTTATAGGCTTCTAG
AACAGCGAAGGATAAGCGACGCAA -> ACAGCGAAGGATAAGCGACGCAAC
GGCAGGCGTTGTCATGTCCCGCGT -> GCAGGCGTTGTCATGTCCCGCGTT
CGGAGCTTAATACCTACTTCAAAA -> GGAGCTTAATACCTACTTCAAAAC
CGACGCCTGCCTCTCCAGGAGTTC -> GACGCCTGCCTCTCCAGGAGTTCG
GGATAAGCGACGCAACAGCCGGTC -> GATAAGCGACGCAACAGCCGGTCT
TCGAGTCCGTGATGCCTGGTAAGC -> CGAGTCCGTGATGCCTGGTAAGCA
CACCACACGTGGATGCCCGGTCGT -> ACCACACGTGGATGCCCGGTCGTC
ACACCGGTGCACAGTGTTGAGTGG -> CACCGGTGCACAGTGTTGAGTGGG
TGTGCGGTTCCCTCCATAGGTACG -> GTGCGGTTCCCTCCATAGGTACGC
TGGTAAGCAGTTTGGGGCAGACAC -> GGTAAGCAGTTTGGGGCAGACACG
ATGCACTCTGGAGCACAATACCGA -> TGCACTCTGGAGCACAATACCGAG
CATAAAACAGTGCAGCAATATCCC -> ATAAAACAGTGCAGCAATATCCCG
AACCTCTGCTTAGATGTTACATCG -> ACCTCTGCTTAGATGTTACATCGG
ATAATGCACTCTGGAGCACAATAC -> TAATGCACTCTGGAGCACAATACC
AGGCTTCATTAGTCGTTACTTGGT -> GGCTTCATTAGTCGTTACTTGGTG
TGCAGTCCATTTGCTTTGGAGGTT -> GCAGTCCATTTGCTTTGGAGGTTT
CATAATGCACTCTGGAGCACAATA -> ATAATGCACTCTGGAGCACAATAC
GAAGTATCGCACTAGTGTTTGGCG -> AAGTATCGCACTAGTGTTTGGCGG
GGCGTTGTCATGTCCCGCGTTCCC -> GCGTTGTCATGTCCCGCGTTCCCG
ATACTGAAAGTGTCTGGTATCATA -> TACTGAAAGTGTCTGGTATCATAA
GCTTTGGAGGTTTTGCCTGTAAAG -> CTTTGGAGGTTTTGCCTGTAAAGC
GGATGAGATATTTCGGATTTGTGC -> GATGAGATATTTCGGATTTGTGCC
AGGCTTCTAGAATCAAGAATCTGA -> GGCTTCTAGAATCAAGAATCTGAG
TAGCCTGCGTATCAGTCCCGACCG -> AGCCTGCGTATCAGTCCCGACCGC
GCGTCTTTCATGAATTGACGGCAG -> CGTCTTTCATGAATTGACGGCAGG
AAACACACGGCGATGAGGCGTCAG -> AACACACGGCGATGAGGCGTCAGC
GTGACCACAAAGATGTCAGTTTTG -> TGACCACAAAGATGTCAGTTTTGA
TGGTATCATAAAACAGTGCAGCAA -> GGTATCATAAAACAGTGCAGCAAT
TCGTTACTTGGTGGGAGCACGACT -> CGTTACTTGGTGGGAGCACGACTA
TCATAGTTACGAACGCTCGCATGG -> CATAGTTACGAACGCTCGCATGGC
GCATGTCTAAGCTTGCTGGGCTCG -> CATGTCTAAGCTTGCTGGGCTCGA
GATGCCCGGTCGTCGAGTGACGTA -> ATGCCCGGTCGTCGAGTGACGTAC
GTCGAGTGACGTACTCAACTAGAC -> TCGAGTGACGTACTCAACTAGACA
GCCTCTTGCGTCTTTCATGAATTG -> CCTCTTGCGTCTTTCATGAATTGA
GACAACTCGGGGAGCCACATGAGA -> ACAACTCGGGGAGCCACATGAGAA
TTTGGGGCAGACACGATCAAGTCA -> TTGGGGCAGACACGATCAAGTCAC
GTATCGCACTAGTGTTTGGCGGGA -> TATCGCACTAGTGTTTGGCGGGAG
GGAACGTCCGGTGACTGTTATGCC -> GAACGTCCGGTGACTGTTATGCCT
CTTCATTAGTCGTTACTTGGTGGG -> TTCATTAGTCGTTACTTGGTGGGA
CTAGACAGCGCCTGACCATCACCT -> TAGACAGCGCCTGACCATCACCTT
TGCCTGTAAAGCGAAGGGGTGATG -> GCCTGTAAAGCGAAGGGGTGATGC
CTTTGTCGGCATGTCTAAGCTTGC -> TTTGTCGGCATGTCTAAGCTTGCT
AGCAGTTTGGGGCAGACACGATCA -> GCAGTTTGGGGCAGACACGATCAA
CTAGTATCGCAGGAGGTTTATCGC -> TAGTATCGCAGGAGGTTTATCGCG
ATAATGCGATCACGGATACTTGTC -> TAATGCGATCACGGATACTTGTCG
GACCGACCTAAAAGAATATGCGTC -> ACCGACCTAAAAGAATATGCGTCC
ACGAAATGACCGGGATTAACTCGT -> CGAAATGACCGGGATTAACTCGTC
CCTGCCTCTCCAGGAGTTCGTTAT -> CTGCCTCTCCAGGAGTTCGTTATG
GGTGACTGTTATGCCTCTTGCGTC -> GTGACTGTTATGCCTCTTGCGTCT
GTTCAGTAACAAGTCGTGCCGTGG -> TTCAGTAACAAGTCGTGCCGTGGG
AGTAGTGCAGGCGGTTGCGGCCCG -> GTAGTGCAGGCGGTTGCGGCCCGT
CTGATGCGCACTTTCAGTAGACAT -> TGATGCGCACTTTCAGTAGACATC
TACCATAGACTTAGGACGGAAGTT -> ACCATAGACTTAGGACGGAAGTTT
CGCGTTCCCGCGGGATGAGATATT -> GCGTTCCCGCGGGATGAGATATTT
CGTACTCAACTAGACAGCGCCTGA -> GTACTCAACTAGACAGCGCCTGAC
GAAAATGGCACTGCCCTAGATTTC -> AAAATGGCACTGCCCTAGATTTCA
CACACCGGTGCACAGTGTTGAGTG -> ACACCGGTGCACAGTGTTGAGTGG
CGCGGGATGAGATATTTCGGATTT -> GCGGGATGAGATATTTCGGATTTG
AAATAGCGGGCACCACACGTGGAT -> AATAGCGGGCACCACACGTGGATG
GGGCGCCCCAAGCCAAGGATGATA -> GGCGCCCCAAGCCAAGGATGATAG
AGGGGTGTAAGCATGATATACCAT -> GGGGTGTAAGCATGATATACCATA
GTGGGCTTCGGGTTCTCCGTCTGA -> TGGGCTTCGGGTTCTCCGTCTGAC
ATGTCTAAGCTTGCTGGGCTCGAA -> TGTCTAAGCTTGCTGGGCTCGAAG
TTATGCCTCTTGCGTCTTTCATGA -> TATGCCTCTTGCGTCTTTCATGAA
CACGCAGTTCGGAGCTTAATACCT -> ACGCAGTTCGGAGCTTAATACCTA
CCGGCCCTCGCTTAATTGCACGAA -> CGGCCCTCGCTTAATTGCACGAAG
TATGGATTCGTTATGTCGAAACGA -> ATGGATTCGTTATGTCGAAACGAT
TTGAACCTCTGCTTAGATGTTACA -> TGAACCTCTGCTTAGATGTTACAT
GGACCTAGTTCAGTAACAAGTCGT -> GACCTAGTTCAGTAACAAGTCGTG
ATACTTGTCGTAACTACGCACCCC -> TACTTGTCGTAACTACGCACCCCC
TATCCCGTCATAGTTACGAACGCT -> ATCCCGTCATAGTTACGAACGCTC
CCGGGATTAACTCGTCTTAATACT -> CGGGATTAACTCGTCTTAATACTG
TCTAAGCTTGCTGGGCTCGAAGTA -> CTAAGCTTGCTGGGCTCGAAGTAT
CGTCTTTCATGAATTGACGGCAGG -> GTCTTTCATGAATTGACGGCAGGC
TAATACGCTATATAATTTGCAGCT -> AATACGCTATATAATTTGCAGCTT
AGCAATATCCCGTCATAGTTACGA -> GCAATATCCCGTCATAGTTACGAA
ATCGCATATCCTAGCAGCGACCAG -> TCGCATATCCTAGCAGCGACCAGG
AACAGTGCAGCAATATCCCGTCAT -> ACAGTGCAGCAATATCCCGTCATA
TGGGCTTCGGGTTCTCCGTCTGAC -> GGGCTTCGGGTTCTCCGTCTGACA
AGCATAGTGCGTCGAAGTAGACTC -> GCATAGTGCGTCGAAGTAGACTCC
AGTAACAAGTCGTGCCGTGGGCCG -> GTAACAAGTCGTGCCGTGGGCCGC
ACAGCGCCTGACCATCACCTTCAC -> CAGCGCCTGACCATCACCTTCACC
AGAAAGCTACGCTGAATAAACAGT -> GAAAGCTACGCTGAATAAACAGTC
ATGACAGCACGGACTTAGCCTGCG -> TGACAGCACGGACTTAGCCTGCGT
CCTGAGAAAGAAAGCTACGCTGAA -> CTGAGAAAGAAAGCTACGCTGAAT
TCTGGCAAGTAATAGTAGTGCAGG -> CTGGCAAGTAATAGTAGTGCAGGC
CGAAACTTTATTCAGTTAACACGA -> GAAACTTTATTCAGTTAACACGAA
GCTCGCATGGCGTGCAGGTGTATA -> CTCGCATGGCGTGCAGGTGTATAG
AACACGAAATGACCGGGATTAACT -> ACACGAAATGACCGGGATTAACTC
CCTATCTAATACGCTATATAATTT -> CTATCTAATACGCTATATAATTTG
ATAGACTTAGGACGGAAGTTTCCT -> TAGACTTAGGACGGAAGTTTCCTA
CCGGTGCACAGTGTTGAGTGGGGA -> CGGTGCACAGTGTTGAGTGGGGAC
GGCTTCTAGAATCAAGAATCTGAG -> GCTTCTAGAATCAAGAATCTGAGA
TAATGCGATCACGGATACTTGTCG -> AATGCGATCACGGATACTTGTCGT
CGGCGATGAGGCGTCAGCCGAAAC -> GGCGATGAGGCGTCAGCCGAAACT
AGATTTCAACCATGACAGCACGGA -> GATTTCAACCATGACAGCACGGAC
GACCTAAAAGAATATGCGTCCTTC -> ACCTAAAAGAATATGCGTCCTTCT
CTAGTGTTTGGCGGGAGGGGTGTA -> TAGTGTTTGGCGGGAGGGGTGTAA
GCTATATAATTTGCAGCTTATAAT -> CTATATAATTTGCAGCTTATAATG
CCACATGAGAAACCTAGTATCGCA -> CACATGAGAAACCTAGTATCGCAG
CGAGTGACGTACTCAACTAGACAG -> GAGTGACGTACTCAACTAGACAGC
GTACTCAACTAGACAGCGCCTGAC -> TACTCAACTAGACAGCGCCTGACC
CGCTATATAATTTGCAGCTTATAA -> GCTATATAATTTGCAGCTTATAAT
AGCAGACATAATGCACTCTGGAGC -> GCAGACATAATGCACTCTGGAGCA
CTGGAGCACAATACCGAGTGTTAA -> TGGAGCACAATACCGAGTGTTAAC
GCACGACTAATCCTCGGATGGCTC -> CACGACTAATCCTCGGATGGCTCT
TAGTAGTGCAGGCGGTTGCGGCCC -> AGTAGTGCAGGCGGTTGCGGCCCG
CCCGGCCCTCGCTTAATTGCACGA -> CCGGCCCTCGCTTAATTGCACGAA
ACTCCCATGTGCGGTTCCCTCCAT -> CTCCCATGTGCGGTTCCCTCCATA
CAGGAGGTTTATCGCGCCAAATAG -> AGGAGGTTTATCGCGCCAAATAGC
TGGATTCGTTATGTCGAAACGATG -> GGATTCGTTATGTCGAAACGATGG
GTTATGGATTCGTTATGTCGAAAC -> TTATGGATTCGTTATGTCGAAACG
GACACGATCAAGTCACAAAGGTAT -> ACACGATCAAGTCACAAAGGTATG
CCTACTTCAAAACGACTTAGAGGA -> CTACTTCAAAACGACTTAGAGGAA
GCCCGGTCGTCGAGTGACGTACTC -> CCCGGTCGTCGAGTGACGTACTCA
TGACTCAAACAGCGAAGGATAAGC -> GACTCAAACAGCGAAGGATAAGCG
TGAGAAACCTAGTATCGCAGGAGG -> GAGAAACCTAGTATCGCAGGAGGT
CTTCTAGAATCAAGAATCTGAGAC -> TTCTAGAATCAAGAATCTGAGACG
GCACCCCCAACAAACAGCCAACTC -> CACCCCCAACAAACAGCCAACTCC
TTTATTCAGTTAACACGAAATGAC -> TTATTCAGTTAACACGAAATGACC
TAGTCGACGCCTGCCTCTCCAGGA -> AGTCGACGCCTGCCTCTCCAGGAG
TGGCTTGAACCTCTGCTTAGATGT -> GGCTTGAACCTCTGCTTAGATGTT
TCGCAGGAGGTTTATCGCGCCAAA -> CGCAGGAGGTTTATCGCGCCAAAT
GTGCGGTTCCCTCCATAGGTACGC -> TGCGGTTCCCTCCATAGGTACGCC
AGTCGACGCCTGCCTCTCCAGGAG -> GTCGACGCCTGCCTCTCCAGGAGT
TACGCTATATAATTTGCAGCTTAT -> ACGCTATATAATTTGCAGCTTATA
GTGCCAAATGCTGCAGTCCATTTG -> TGCCAAATGCTGCAGTCCATTTGC
TCCCTTTGTCGGCATGTCTAAGCT -> CCCTTTGTCGGCATGTCTAAGCTT
GCGGTTGCGGCCCGTAGCCTGAGA -> CGGTTGCGGCCCGTAGCCTGAGAA
TGTATAGCTCTGTTAGTCGACGCC -> GTATAGCTCTGTTAGTCGACGCCT
TTGAGTGGGGACGAAAATGGCACT -> TGAGTGGGGACGAAAATGGCACTG
TCCCGTTCGGTGGGCTTCGGGTTC -> CCCGTTCGGTGGGCTTCGGGTTCT
TGGGGACGAAAATGGCACTGCCCT -> GGGGACGAAAATGGCACTGCCCTA
AGTCCCGACCGCTACGTGCGGACC -> GTCCCGACCGCTACGTGCGGACCT
CTCTCGGTAATTGGGCGCCCCAAG -> TCTCGGTAATTGGGCGCCCCAAGC
CCTCGCTTAATTGCACGAAGCAGA -> CTCGCTTAATTGCACGAAGCAGAC
GGGATGAGATATTTCGGATTTGTG -> GGATGAGATATTTCGGATTTGTGC
TTCGGATTTGTGCCAAATGCTGCA -> TCGGATTTGTGCCAAATGCTGCAG
AAACAGTGCAGCAATATCCCGTCA -> AACAGTGCAGCAATATCCCGTCAT
CTGACCATCACCTTCACCATCCTC -> TGACCATCACCTTCACCATCCTCG
GCGGCCCGTAGCCTGAGAAAGAAA -> CGGCCCGTAGCCTGAGAAAGAAAG
GCACTGCCCTAGATTTCAACCATG -> CACTGCCCTAGATTTCAACCATGA
AGCACAATACCGAGTGTTAACCCG -> GCACAATACCGAGTGTTAACCCGA
GGCTCGAAGTATCGCACTAGTGTT -> GCTCGAAGTATCGCACTAGTGTTT
CTTTGGAGGTTTTGCCTGTAAAGC -> TTTGGAGGTTTTGCCTGTAAAGCG
TTATGACTCAAACAGCGAAGGATA -> TATGACTCAAACAGCGAAGGATAA
CGCATGGCGTGCAGGTGTATAGCT -> GCATGGCGTGCAGGTGTATAGCTC
CCATAGGTACGCCCCGATCGCATA -> CATAGGTACGCCCCGATCGCATAT
CATCGGGCGCCTAGAAGCATCCGT -> ATCGGGCGCCTAGAAGCATCCGTG
CCAAGCCAAGGATGATAGCAACAC -> CAAGCCAAGGATGATAGCAACACC
TAGATTTCAACCATGACAGCACGG -> AGATTTCAACCATGACAGCACGGA
TCGCGCCAAATAGCGGGCACCACA -> CGCGCCAAATAGCGGGCACCACAC
GGGCTTCGGGTTCTCCGTCTGACA -> GGCTTCGGGTTCTCCGTCTGACAC
AGACGTTGTGACCGACCTAAAAGA -> GACGTTGTGACCGACCTAAAAGAA
ATATCCCGTCATAGTTACGAACGC -> TATCCCGTCATAGTTACGAACGCT
GTTGCGGCCCGTAGCCTGAGAAAG -> TTGCGGCCCGTAGCCTGAGAAAGA
ATCGCACTAGTGTTTGGCGGGAGG -> TCGCACTAGTGTTTGGCGGGAGGG
GCCTGACCATCACCTTCACCATCC -> CCTGACCATCACCTTCACCATCCT
CTGGTATCATAAAACAGTGCAGCA -> TGGTATCATAAAACAGTGCAGCAA
TTCTGGCAAGTAATAGTAGTGCAG -> TCTGGCAAGTAATAGTAGTGCAGG
GAGCACAATACCGAGTGTTAACCC -> AGCACAATACCGAGTGTTAACCCG
TGTTATGCCTCTTGCGTCTTTCAT -> GTTATGCCTCTTGCGTCTTTCATG
CTCAATATTCCCGTTCGGTGGGCT -> TCAATATTCCCGTTCGGTGGGCTT
CCTGTAAAGCGAAGGGGTGATGCG -> CTGTAAAGCGAAGGGGTGATGCGC
GCTTAATTGCACGAAGCAGACATA -> CTTAATTGCACGAAGCAGACATAA
GGAGCACGACTAATCCTCGGATGG -> GAGCACGACTAATCCTCGGATGGC
ATACCGAGTGTTAACCCGATGGAA -> TACCGAGTGTTAACCCGATGGAAC
AGTGTTTGGCGGGAGGGGTGTAAG -> GTGTTTGGCGGGAGGGGTGTAAGC
CACGAAATGACCGGGATTAACTCG -> ACGAAATGACCGGGATTAACTCGT
TAGTTGAGCATAGTGCGTCGAAGT -> AGTTGAGCATAGTGCGTCGAAGTA
TAACCTCTCGTCTGATGCGCACTT -> AACCTCTCGTCTGATGCGCACTTT
CGCACCCCCAACAAACAGCCAACT -> GCACCCCCAACAAACAGCCAACTC
AGGTGTATAGCTCTGTTAGTCGAC -> GGTGTATAGCTCTGTTAGTCGACG
TGACGGCAGGCGTTGTCATGTCCC -> GACGGCAGGCGTTGTCATGTCCCG
ATAAACAGTCTTAACTTATCGAGC -> TAAACAGTCTTAACTTATCGAGCA
TGCACAGTGTTGAGTGGGGACGAA -> GCACAGTGTTGAGTGGGGACGAAA
CACCAAAAGAAGTTGAGTTCTGGG -> ACCAAAAGAAGTTGAGTTCTGGGA
GTGCCCCGGCCCTCGCTTAATTGC -> TGCCCCGGCCCTCGCTTAATTGCA
GTATCATAAAACAGTGCAGCAATA -> TATCATAAAACAGTGCAGCAATAT
ACCATGACAGCACGGACTTAGCCT -> CCATGACAGCACGGACTTAGCCTG
AGCAGCGACCAGGCGTCGCGACTC -> GCAGCGACCAGGCGTCGCGACTCG
TCATTAGTCGTTACTTGGTGGGAG -> CATTAGTCGTTACTTGGTGGGAGC
GATGCGCACTTTCAGTAGACATCC -> ATGCGCACTTTCAGTAGACATCCC
GGAACTTGTCCCTTATGACTCAAA -> GAACTTGTCCCTTATGACTCAAAC
CTTGTCGTAACTACGCACCCCCAA -> TTGTCGTAACTACGCACCCCCAAC
TAGAAGCATCCGTGACCACAAAGA -> AGAAGCATCCGTGACCACAAAGAT
TGATCGTGTTAGAGAAAACACACG -> GATCGTGTTAGAGAAAACACACGG
AACGACTTAGAGGAATGGGCCGTT -> ACGACTTAGAGGAATGGGCCGTTA
AAGTATCGCACTAGTGTTTGGCGG -> AGTATCGCACTAGTGTTTGGCGGG
CGGATGGCTCTCAATATTCCCGTT -> GGATGGCTCTCAATATTCCCGTTC
TCGTCGAGTGACGTACTCAACTAG -> CGTCGAGTGACGTACTCAACTAGA
GCATAGTGCGTCGAAGTAGACTCC -> CATAGTGCGTCGAAGTAGACTCCT
TTTCGGATTTGTGCCAAATGCTGC -> TTCGGATTTGTGCCAAATGCTGCA
GTCAGTTTTGAACCCTCACACCGG -> TCAGTTTTGAACCCTCACACCGGT
GTAATAGTAGTGCAGGCGGTTGCG -> TAATAGTAGTGCAGGCGGTTGCGG
TAAGCTTGCTGGGCTCGAAGTATC -> AAGCTTGCTGGGCTCGAAGTATCG
AACCATGACAGCACGGACTTAGCC -> ACCATGACAGCACGGACTTAGCCT
CATTTGCTTTGGAGGTTTTGCCTG -> ATTTGCTTTGGAGGTTTTGCCTGT
TGCTTTGGAGGTTTTGCCTGTAAA -> GCTTTGGAGGTTTTGCCTGTAAAG
GAGAAAGAAAGCTACGCTGAATAA -> AGAAAGAAAGCTACGCTGAATAAA
ATTCGTTATGTCGAAACGATGGCT -> TTCGTTATGTCGAAACGATGGCTT
CGGGGAGCCACATGAGAAACCTAG -> GGGGAGCCACATGAGAAACCTAGT
CCCAAGCCAAGGATGATAGCAACA -> CCAAGCCAAGGATGATAGCAACAC
CTTCTGGCAAGTAATAGTAGTGCA -> TTCTGGCAAGTAATAGTAGTGCAG
AAGACTGTTTTCCGTCGCTGTCTT -> AGACTGTTTTCCGTCGCTGTCTTC
CTCAACTAGACAGCGCCTGACCAT -> TCAACTAGACAGCGCCTGACCATC
GCAGGTGTATAGCTCTGTTAGTCG -> CAGGTGTATAGCTCTGTTAGTCGA
CCTGACCATCACCTTCACCATCCT -> CTGACCATCACCTTCACCATCCTC
CTTATAATGCGATCACGGATACTT -> TTATAATGCGATCACGGATACTTG
GTTGAGCATAGTGCGTCGAAGTAG -> TTGAGCATAGTGCGTCGAAGTAGA
TTTATCGCGCCAAATAGCGGGCAC -> TTATCGCGCCAAATAGCGGGCACC
CGCTACGTGCGGACCTAGTTCAGT -> GCTACGTGCGGACCTAGTTCAGTA
CCAACGACAACTCGGGGAGCCACA -> CAACGACAACTCGGGGAGCCACAT
GCCCGTAGCCTGAGAAAGAAAGCT -> CCCGTAGCCTGAGAAAGAAAGCTA
CACTGGAACGTCCGGTGACTGTTA -> ACTGGAACGTCCGGTGACTGTTAT
ACAATACCGAGTGTTAACCCGATG -> CAATACCGAGTGTTAACCCGATGG
ATCTAATACGCTATATAATTTGCA -> TCTAATACGCTATATAATTTGCAG
CAGTTTTGAACCCTCACACCGGTG -> AGTTTTGAACCCTCACACCGGTGC
TGAGCATAGTGCGTCGAAGTAGAC -> GAGCATAGTGCGTCGAAGTAGACT
CTAGCAGCGACCAGGCGTCGCGAC -> TAGCAGCGACCAGGCGTCGCGACT
AGCTCTGTTAGTCGACGCCTGCCT -> GCTCTGTTAGTCGACGCCTGCCTC
GGGCGCCTAGAAGCATCCGTGACC -> GGCGCCTAGAAGCATCCGTGACCA
AGCCTGAGAAAGAAAGCTACGCTG -> GCCTGAGAAAGAAAGCTACGCTGA
TTTCAGTAGACATCCCTACTACCA -> TTCAGTAGACATCCCTACTACCAA
ATAAAACAGTGCAGCAATATCCCG -> TAAAACAGTGCAGCAATATCCCGT
TCAAACAGCGAAGGATAAGCGACG -> CAAACAGCGAAGGATAAGCGACGC
CGTGGGCCGCTGATCGTGTTAGAG -> GTGGGCCGCTGATCGTGTTAGAGA
GACATAATGCACTCTGGAGCACAA -> ACATAATGCACTCTGGAGCACAAT
CTCGTCTGATGCGCACTTTCAGTA -> TCGTCTGATGCGCACTTTCAGTAG
CAGGTGTATAGCTCTGTTAGTCGA -> AGGTGTATAGCTCTGTTAGTCGAC
GATGCCTGGTAAGCAGTTTGGGGC -> ATGCCTGGTAAGCAGTTTGGGGCA
TGCTGGGCTCGAAGTATCGCACTA -> GCTGGGCTCGAAGTATCGCACTAG
ACCGCTACGTGCGGACCTAGTTCA -> CCGCTACGTGCGGACCTAGTTCAG
TCCATAGGTACGCCCCGATCGCAT -> CCATAGGTACGCCCCGATCGCATA
AAAGCCTCCACGCAGTTCGGAGCT -> AAGCCTCCACGCAGTTCGGAGCTT
TGCACTCTGGAGCACAATACCGAG -> GCACTCTGGAGCACAATACCGAGT
AAGCGACGCAACAGCCGGTCTCCC -> AGCGACGCAACAGCCGGTCTCCCT
CACGGACTTAGCCTGCGTATCAGT -> ACGGACTTAGCCTGCGTATCAGTC
GAAACTTTATTCAGTTAACACGAA -> AAACTTTATTCAGTTAACACGAAA
AGATGTTACATCGGTAGAAGACTG -> GATGTTACATCGGTAGAAGACTGT
ACCAAAAGAAGTTGAGTTCTGGGA -> CCAAAAGAAGTTGAGTTCTGGGAT
CAAATAGCGGGCACCACACGTGGA -> AAATAGCGGGCACCACACGTGGAT
AAGAATATGCGTCCTTCTGTGCCC -> AGAATATGCGTCCTTCTGTGCCCC
TTCGTTATGTCGAAACGATGGCTT -> TCGTTATGTCGAAACGATGGCTTG
TAGGACGGAAGTTTCCTATCTAAT -> AGGACGGAAGTTTCCTATCTAATA
GGGGTGTAAGCATGATATACCATA -> GGGTGTAAGCATGATATACCATAG
GGATTTGTGCCAAATGCTGCAGTC -> GATTTGTGCCAAATGCTGCAGTCC
